"gid","varon","mujer","total_poblacion","hogares","viviendas_particulares","superficie","densidad_poblacion","zona"
1,536,680,1216,454,410,12.96,94,"{""type"":""Polygon"",""coordinates"":[[[-58.8438409493679,-27.4620647989804],[-58.8437695685192,-27.4620296575113],[-58.8436592427718,-27.4620852485494],[-58.8434562625287,-27.4620428277522],[-58.8430890978192,-27.4618582331456],[-58.8428740562624,-27.4616986891958],[-58.8425240108164,-27.4616311483803],[-58.8423833503823,-27.4616871398415],[-58.8422495016695,-27.4615445638673],[-58.8421266645629,-27.4614559722033],[-58.8419126747823,-27.4613595646014],[-58.8416395160929,-27.4613541562003],[-58.8413969915276,-27.4613663855111],[-58.8412313519655,-27.4614407495522],[-58.8411602720595,-27.4614236461029],[-58.8413256118408,-27.4613312427248],[-58.8414363878855,-27.4613027126394],[-58.8414760840318,-27.4612570791773],[-58.8413736205826,-27.4611772390486],[-58.8412907805088,-27.4610610525635],[-58.8412532170721,-27.4609307347541],[-58.8411395934954,-27.4607878901566],[-58.8410467924758,-27.4606808569086],[-58.8409548908551,-27.4606279418664],[-58.8408244920112,-27.4606928177596],[-58.8407865940566,-27.4608466876062],[-58.8407898160069,-27.4610406114448],[-58.8407110226491,-27.4611679568446],[-58.8404589861931,-27.4612163970377],[-58.8403178756341,-27.4612453272941],[-58.8400448669109,-27.4612489354619],[-58.8398389305237,-27.4613328520997],[-58.83958599464,-27.4613271724356],[-58.8393932781866,-27.4612936316896],[-58.839160714981,-27.4612967038089],[-58.8390085941588,-27.4612716479898],[-58.8389764632787,-27.4611638119718],[-58.8388644889921,-27.4611201823407],[-58.8387404163517,-27.4612616572437],[-58.8388035891315,-27.4617164188125],[-58.8388781406757,-27.4628566791038],[-58.8389574508662,-27.4639788328857],[-58.8402299500694,-27.4638672916249],[-58.8414317393709,-27.4637611848885],[-58.8427950118863,-27.4636348871977],[-58.8440066812672,-27.4635150950872],[-58.8439096231059,-27.4628487760101],[-58.8438409493679,-27.4620647989804]]]}"
2,371,472,843,312,330,22.87,37,"{""type"":""Polygon"",""coordinates"":[[[-58.8387404163517,-27.4612616572437],[-58.8383767784927,-27.4612890132082],[-58.8381442151638,-27.4612920836297],[-58.8378798212084,-27.4612053567959],[-58.8377975831122,-27.4611252469662],[-58.8376157268426,-27.461136668897],[-58.8374131988851,-27.4611212982715],[-58.8372509671468,-27.4610963739333],[-58.8373091677704,-27.4609467478244],[-58.8372875987663,-27.4608658370938],[-58.836786335936,-27.4608273420171],[-58.8363601614673,-27.4607427462844],[-58.8357320583571,-27.4606788550433],[-58.8350669225876,-27.4605162101802],[-58.8348484072557,-27.4604514270474],[-58.8348910650307,-27.4611951561492],[-58.8349222443182,-27.4615511028522],[-58.8349769335449,-27.4621052173148],[-58.8350957534495,-27.4631727238674],[-58.8352319852853,-27.464375326176],[-58.8353459049409,-27.4654519183278],[-58.8354606494823,-27.4665781186525],[-58.836652438006,-27.4664766947431],[-58.8379556792814,-27.4663873218893],[-58.8390816599316,-27.4662822352395],[-58.8389970648884,-27.4651466192314],[-58.8389574508662,-27.4639788328857],[-58.8388781406757,-27.4628566791038],[-58.8388035891315,-27.4617164188125],[-58.8387404163517,-27.4612616572437]]]}"
3,499,660,1159,403,434,13.06,89,"{""type"":""Polygon"",""coordinates"":[[[-58.8440066812672,-27.4635150950872],[-58.8427950118863,-27.4636348871977],[-58.8414317393709,-27.4637611848885],[-58.8402299500694,-27.4638672916249],[-58.8389574508662,-27.4639788328857],[-58.8389970648884,-27.4651466192314],[-58.8390816599316,-27.4662822352395],[-58.840440435994,-27.4661875947756],[-58.8415716918907,-27.4660959509077],[-58.8428743216465,-27.465970453608],[-58.8441120466821,-27.4658954231898],[-58.8441227865398,-27.4647179517155],[-58.8440066812672,-27.4635150950872]]]}"
4,365,450,815,294,337,16.95,48,"{""type"":""Polygon"",""coordinates"":[[[-58.8438409493679,-27.4620647989804],[-58.8439096231059,-27.4628487760101],[-58.8440066812672,-27.4635150950872],[-58.8441227865398,-27.4647179517155],[-58.8441120466821,-27.4658954231898],[-58.8441913387267,-27.4670130609641],[-58.8454588835592,-27.466906047295],[-58.8455536591236,-27.4680415217192],[-58.8468163831713,-27.4679480917243],[-58.8474931352942,-27.4678940038392],[-58.8481144211049,-27.4678496707003],[-58.8480543048852,-27.4672775929905],[-58.8479892840058,-27.4667146019624],[-58.8478745629019,-27.4655974379392],[-58.8478616675451,-27.4654307082301],[-58.8478207406003,-27.4644929978306],[-58.8476681626469,-27.46444089278],[-58.8474021000828,-27.4642549683857],[-58.847209677585,-27.4642394781975],[-58.8467978994885,-27.4641096158757],[-58.8464930463033,-27.4640234426126],[-58.8462788977126,-27.4639180225085],[-58.8462363466559,-27.4637922833176],[-58.8460433238139,-27.4637407127366],[-58.8457570423151,-27.4635550531039],[-58.8455570859914,-27.4633908027694],[-58.8454736388654,-27.4632385403609],[-58.8455018700364,-27.463111862659],[-58.8453594065302,-27.4630596208891],[-58.8452178445428,-27.4630614970954],[-58.8450551580846,-27.463009523021],[-58.8448541283463,-27.4630843603456],[-58.8445995367638,-27.4629794734029],[-58.844463431129,-27.4627016044172],[-58.8442284632488,-27.4625603700475],[-58.8440780926509,-27.4623368196672],[-58.8438409493679,-27.4620647989804]]]}"
5,326,384,710,259,323,16.21,44,"{""type"":""Polygon"",""coordinates"":[[[-58.8478207406003,-27.4644929978306],[-58.8478616675451,-27.4654307082301],[-58.8478745629019,-27.4655974379392],[-58.8479892840058,-27.4667146019624],[-58.8480543048852,-27.4672775929905],[-58.8481144211049,-27.4678496707003],[-58.8493972880226,-27.4677514391819],[-58.8494174152704,-27.4683511122574],[-58.8494362627261,-27.4688741181683],[-58.8507850186467,-27.4687840197598],[-58.8527896964101,-27.4686039851474],[-58.8536271873994,-27.469693477178],[-58.8544846176006,-27.4707646544959],[-58.8550693888405,-27.4706531139509],[-58.8549592024111,-27.4701132837704],[-58.8547487268844,-27.4696244087253],[-58.8545221824896,-27.4693838425603],[-58.8540980006495,-27.4691188434982],[-58.8540210256819,-27.4687499811922],[-58.8538857948169,-27.4685262409797],[-58.8537936543945,-27.4684598056415],[-58.8537500361575,-27.4682709318696],[-58.8536077134425,-27.4682277187395],[-58.8534026058477,-27.4680590382762],[-58.8533014860419,-27.4680603845026],[-58.8532936378904,-27.4681958137268],[-58.8531027172617,-27.4682705284853],[-58.8529302096571,-27.4682367381043],[-58.8526168150416,-27.4679431945962],[-58.8524299723004,-27.4676569880682],[-58.8523131598361,-27.4673247412073],[-58.8523088610079,-27.4670676812792],[-58.8523257664089,-27.4668689799631],[-58.8522619277214,-27.4666803746113],[-58.8519057505534,-27.4665497882256],[-58.8516211109404,-27.4664633577312],[-58.8514068023365,-27.4663489263756],[-58.8512579195443,-27.4662155813698],[-58.85112480776,-27.4661181131237],[-58.8509729797896,-27.4661111101691],[-58.8508501308883,-27.4660225268547],[-58.8508477948976,-27.4658827221916],[-58.850694761683,-27.4658035616649],[-58.8504827154362,-27.4658244236292],[-58.850382501525,-27.4658798855842],[-58.8502705184284,-27.4658362656155],[-58.8501301584871,-27.4659103042637],[-58.8498116366616,-27.4659145368394],[-58.8496998043405,-27.4658799360637],[-58.8496578510154,-27.4657902768293],[-58.8496555918571,-27.4656549818983],[-58.8495433080424,-27.4655933219923],[-58.8494310243493,-27.465531661989],[-58.8494062831567,-27.4652613407279],[-58.8493747432373,-27.4651895863821],[-58.8491216485523,-27.4651749048457],[-58.8489495983865,-27.4651681682159],[-58.8488471260957,-27.4650883340764],[-58.8484548140734,-27.4649131100145],[-58.848177659248,-27.4646686936286],[-58.8478207406003,-27.4644929978306]]]}"
6,390,460,850,306,377,6.04,141,"{""type"":""Polygon"",""coordinates"":[[[-58.8481144211049,-27.4678496707003],[-58.8474931352942,-27.4678940038392],[-58.8468163831713,-27.4679480917243],[-58.8455536591236,-27.4680415217192],[-58.8454588835592,-27.466906047295],[-58.8441913387267,-27.4670130609641],[-58.8442753136174,-27.4681080822464],[-58.8443575635223,-27.4690993768596],[-58.8456454312352,-27.4689966022444],[-58.8456579482475,-27.4691407830269],[-58.8469257406834,-27.4690472844058],[-58.8481736823598,-27.4689765920039],[-58.8481144211049,-27.4678496707003]]]}"
7,292,392,684,234,304,6.07,113,"{""type"":""Polygon"",""coordinates"":[[[-58.8441120466821,-27.4658954231898],[-58.8428743216465,-27.465970453608],[-58.8415716918907,-27.4660959509077],[-58.8416560896187,-27.4672180343191],[-58.842933677582,-27.4671063998024],[-58.8430008212009,-27.4681024066257],[-58.8431154975331,-27.4692195765802],[-58.8443575635223,-27.4690993768596],[-58.8442753136174,-27.4681080822464],[-58.8441913387267,-27.4670130609641],[-58.8441120466821,-27.4658954231898]]]}"
8,229,336,565,202,260,7.06,80,"{""type"":""Polygon"",""coordinates"":[[[-58.8415716918907,-27.4660959509077],[-58.840440435994,-27.4661875947756],[-58.8405147104407,-27.4673098131066],[-58.8405814578848,-27.4682832728709],[-58.8406814666246,-27.4694322155068],[-58.8418076241107,-27.4693361251466],[-58.8431154975331,-27.4692195765802],[-58.8430008212009,-27.4681024066257],[-58.842933677582,-27.4671063998024],[-58.8416560896187,-27.4672180343191],[-58.8415716918907,-27.4660959509077]]]}"
9,284,395,679,274,398,8.72,78,"{""type"":""Polygon"",""coordinates"":[[[-58.840440435994,-27.4661875947756],[-58.8390816599316,-27.4662822352395],[-58.8379556792814,-27.4663873218893],[-58.8380316591333,-27.4670043049616],[-58.8380802644517,-27.4674953456206],[-58.8381780755572,-27.4685135055934],[-58.8382562295481,-27.4692612741094],[-58.8382981345298,-27.4696531643483],[-58.8393180445441,-27.4695539861624],[-58.8406814666246,-27.4694322155068],[-58.8405814578848,-27.4682832728709],[-58.8405147104407,-27.4673098131066],[-58.840440435994,-27.4661875947756]]]}"
10,264,307,571,203,291,9.03,63,"{""type"":""Polygon"",""coordinates"":[[[-58.8379556792814,-27.4663873218893],[-58.836652438006,-27.4664766947431],[-58.8354606494823,-27.4665781186525],[-58.8355857333241,-27.4677177148612],[-58.8357140825896,-27.468749007234],[-58.8358391728553,-27.4698886026299],[-58.8369802855216,-27.4697788212899],[-58.8382981345298,-27.4696531643483],[-58.8382562295481,-27.4692612741094],[-58.8381780755572,-27.4685135055934],[-58.8380802644517,-27.4674953456206],[-58.8380316591333,-27.4670043049616],[-58.8379556792814,-27.4663873218893]]]}"
11,267,317,584,221,241,8.62,68,"{""type"":""Polygon"",""coordinates"":[[[-58.8393180445441,-27.4695539861624],[-58.8382981345298,-27.4696531643483],[-58.8369802855216,-27.4697788212899],[-58.8358391728553,-27.4698886026299],[-58.8359791358763,-27.4710099580998],[-58.8360892884866,-27.4721632823134],[-58.8372153302519,-27.4720582078814],[-58.8385433931251,-27.4719369237256],[-58.8385786368429,-27.4719274365344],[-58.8394625742288,-27.4718616283619],[-58.8393825742307,-27.470698887916],[-58.8393180445441,-27.4695539861624]]]}"
12,212,279,491,137,161,9.61,51,"{""type"":""Polygon"",""coordinates"":[[[-58.8431154975331,-27.4692195765802],[-58.8418076241107,-27.4693361251466],[-58.8406814666246,-27.4694322155068],[-58.8393180445441,-27.4695539861624],[-58.8393825742307,-27.470698887916],[-58.8394625742288,-27.4718616283619],[-58.8408813425934,-27.4717210800186],[-58.8419768858101,-27.4716073489887],[-58.8432850108361,-27.471504327087],[-58.8431894276583,-27.4703192423638],[-58.8431154975331,-27.4692195765802]]]}"
13,576,697,1273,451,495,12.5,102,"{""type"":""Polygon"",""coordinates"":[[[-58.8481736823598,-27.4689765920039],[-58.8469257406834,-27.4690472844058],[-58.8456579482475,-27.4691407830269],[-58.8456454312352,-27.4689966022444],[-58.8443575635223,-27.4690993768596],[-58.8431154975331,-27.4692195765802],[-58.8431894276583,-27.4703192423638],[-58.8432850108361,-27.471504327087],[-58.8445479276233,-27.4714199353661],[-58.8458460094041,-27.4713215334456],[-58.8471086198457,-27.4712190793396],[-58.8483966585086,-27.471125297862],[-58.8483856429702,-27.4710713141687],[-58.848239219399,-27.4698733773634],[-58.8481448511635,-27.469067191408],[-58.8481736823598,-27.4689765920039]]]}"
14,501,553,1054,357,429,14.57,72,"{""type"":""Polygon"",""coordinates"":[[[-58.8481144211049,-27.4678496707003],[-58.8481736823598,-27.4689765920039],[-58.8481448511635,-27.469067191408],[-58.848239219399,-27.4698733773634],[-58.8483856429702,-27.4710713141687],[-58.8483966585086,-27.471125297862],[-58.8496789602094,-27.4709909833037],[-58.8510017070728,-27.4708561192262],[-58.8510303797022,-27.4710587251489],[-58.8525956679673,-27.4709115989028],[-58.8544846176006,-27.4707646544959],[-58.8536271873994,-27.469693477178],[-58.8527896964101,-27.4686039851474],[-58.8507850186467,-27.4687840197598],[-58.8494362627261,-27.4688741181683],[-58.8494174152704,-27.4683511122574],[-58.8493972880226,-27.4677514391819],[-58.8481144211049,-27.4678496707003]]]}"
15,889,688,1577,413,539,30.33,52,"{""type"":""Polygon"",""coordinates"":[[[-58.8550693888405,-27.4706531139509],[-58.8544846176006,-27.4707646544959],[-58.8525956679673,-27.4709115989028],[-58.8510303797022,-27.4710587251489],[-58.8510017070728,-27.4708561192262],[-58.8496789602094,-27.4709909833037],[-58.8483966585086,-27.471125297862],[-58.8471086198457,-27.4712190793396],[-58.8458460094041,-27.4713215334456],[-58.8445479276233,-27.4714199353661],[-58.8446432264745,-27.4725869788584],[-58.8447674382355,-27.4736679330014],[-58.8448453948075,-27.4747043915451],[-58.8456074703968,-27.4746085829564],[-58.8462128741498,-27.4745193592437],[-58.846894121262,-27.474429126597],[-58.8473986977454,-27.4743592789292],[-58.8473177681158,-27.4734491653347],[-58.8472723684531,-27.4728498273654],[-58.8472191138988,-27.4723859184939],[-58.8485372019819,-27.4722736931519],[-58.8489669033137,-27.4722634752533],[-58.8498152891189,-27.4721890519543],[-58.8498751926238,-27.4727475984622],[-58.8500166586036,-27.4739501090438],[-58.8512478241678,-27.4737803720016],[-58.8517373760645,-27.4737197302574],[-58.8524088013892,-27.4736476448697],[-58.8547301414107,-27.4733460834425],[-58.8556840298888,-27.4732296209735],[-58.8556991985474,-27.4732294187498],[-58.8557194234252,-27.4732291491156],[-58.8557801736357,-27.4732328500059],[-58.8558409238485,-27.4732365508695],[-58.8558712611647,-27.4732361463861],[-58.8559320113799,-27.4732398472096],[-58.8559623486954,-27.4732394427064],[-58.856023098913,-27.4732431434899],[-58.8563462432948,-27.4732117693813],[-58.8561180163636,-27.4725697659627],[-58.8560400490027,-27.4721422778627],[-58.8560066886229,-27.4719622899402],[-58.8558851896016,-27.4719548882611],[-58.8559034491796,-27.4718373635238],[-58.855881712994,-27.4717474369485],[-58.8557588538989,-27.4716588585398],[-58.8556402954664,-27.47152511449],[-58.8555032442221,-27.4711931407655],[-58.855330278138,-27.4711322947578],[-58.8551856091893,-27.4709492792561],[-58.8550693888405,-27.4706531139509]]]}"
16,262,334,596,224,300,5.49,109,"{""type"":""Polygon"",""coordinates"":[[[-58.8500166586036,-27.4739501090438],[-58.8498751926238,-27.4727475984622],[-58.8498152891189,-27.4721890519543],[-58.8489669033137,-27.4722634752533],[-58.8485372019819,-27.4722736931519],[-58.8472191138988,-27.4723859184939],[-58.8472723684531,-27.4728498273654],[-58.8473177681158,-27.4734491653347],[-58.8473986977454,-27.4743592789292],[-58.8477620736268,-27.474313858111],[-58.8481104308257,-27.4742776574227],[-58.8490139248565,-27.4741709309535],[-58.8494424282313,-27.4740885540057],[-58.8496793952173,-27.4740448077759],[-58.8500166586036,-27.4739501090438]]]}"
17,511,655,1166,405,546,13.73,85,"{""type"":""Polygon"",""coordinates"":[[[-58.8445479276233,-27.4714199353661],[-58.8432850108361,-27.471504327087],[-58.8419768858101,-27.4716073489887],[-58.8408813425934,-27.4717210800186],[-58.8409916971586,-27.4728834173946],[-58.8410758735066,-27.4739919706125],[-58.8411865338048,-27.475172346649],[-58.8412017028538,-27.4751721459916],[-58.8416811558609,-27.4751116728425],[-58.842251622386,-27.4750499934653],[-58.842983365453,-27.4749546005667],[-58.8435837926619,-27.4748699648924],[-58.844305495438,-27.4747792089347],[-58.8448453948075,-27.4747043915451],[-58.8447674382355,-27.4736679330014],[-58.8446432264745,-27.4725869788584],[-58.8445479276233,-27.4714199353661]]]}"
18,443,554,997,333,403,18.55,54,"{""type"":""Polygon"",""coordinates"":[[[-58.8408813425934,-27.4717210800186],[-58.8394625742288,-27.4718616283619],[-58.8385786368429,-27.4719274365344],[-58.8385433931251,-27.4719369237256],[-58.8372153302519,-27.4720582078814],[-58.8360892884866,-27.4721632823134],[-58.8362243516092,-27.473293723341],[-58.8363394172495,-27.4744379603387],[-58.8364625343702,-27.4757625245577],[-58.8375478615696,-27.4756399399987],[-58.8377446113183,-27.4756102773065],[-58.8389004245933,-27.4754687082504],[-58.8390770978999,-27.4754483306203],[-58.8396927008802,-27.475363511038],[-58.8403538099656,-27.4752780870846],[-58.8411865338048,-27.475172346649],[-58.8410758735066,-27.4739919706125],[-58.8409916971586,-27.4728834173946],[-58.8408813425934,-27.4717210800186]]]}"
19,503,539,1042,442,463,42.03,25,"{""type"":""Polygon"",""coordinates"":[[[-58.8213157459736,-27.4557979495014],[-58.8214207700632,-27.4563423921347],[-58.8214816442564,-27.4566618682316],[-58.8214824596868,-27.4567114772224],[-58.8215186349696,-27.4573741030421],[-58.8215348993467,-27.4577482931055],[-58.8215773317096,-27.4581762713513],[-58.8215983556522,-27.4585323555872],[-58.8216161035597,-27.4589967436898],[-58.8216317618516,-27.4596415941352],[-58.8216941290139,-27.4615894763393],[-58.8233164413737,-27.4615321543014],[-58.8238771871564,-27.4614977448687],[-58.8246355531725,-27.4614878088066],[-58.825949533057,-27.4614390072679],[-58.8272582321243,-27.4613767300566],[-58.8293609798551,-27.4613220536436],[-58.8297800857711,-27.4612849705195],[-58.8301896758294,-27.4612840981244],[-58.8300922012288,-27.4611996729538],[-58.8300915307776,-27.461159084001],[-58.8300855811056,-27.461105031848],[-58.8300749481717,-27.4610735955637],[-58.8303447543074,-27.460876081984],[-58.830413895354,-27.460775934098],[-58.8305335934639,-27.460675121527],[-58.8306210197089,-27.4604574507312],[-58.8306479262839,-27.4602495973054],[-58.8307863560145,-27.4600583210157],[-58.830925232425,-27.4598941039011],[-58.8310454508417,-27.4598248601225],[-58.8312455909167,-27.4596959239639],[-58.8313904163675,-27.4595857585206],[-58.8314272836051,-27.4593687522477],[-58.8314231092149,-27.4591161988817],[-58.8313490504731,-27.4589186949952],[-58.8311596069488,-27.4587768388404],[-58.831005404226,-27.4586254972864],[-58.8309833186665,-27.4585130161238],[-58.8308814611111,-27.4584692468126],[-58.8307599772767,-27.4584618223725],[-58.8305758889067,-27.4583379384064],[-58.8303922479267,-27.4582411134834],[-58.8302396857912,-27.4581889884559],[-58.8299466095823,-27.4582018620344],[-58.8297799234787,-27.4582130742157],[-58.8295775502072,-27.4582067116403],[-58.8294856557262,-27.4581537886379],[-58.8293808208071,-27.4579296226839],[-58.8293076599856,-27.4577862361162],[-58.8291249142866,-27.4577435280736],[-58.8289641775707,-27.4578087915035],[-58.8287530335594,-27.4578837384999],[-58.8285409961915,-27.4579045665131],[-58.8282743144668,-27.4579847529539],[-58.8279393799468,-27.4579124653838],[-58.8277451842644,-27.457788710197],[-58.8275926238328,-27.4577365821735],[-58.8273399929204,-27.457748919389],[-58.8270164348714,-27.457753165032],[-58.8267074487721,-27.4577211318061],[-58.8266800150023,-27.4572839373095],[-58.8265787548279,-27.4572762438638],[-58.8265751112242,-27.4576687373533],[-58.8263206963217,-27.4575728352289],[-58.8260472485893,-27.4575493561437],[-58.825792982981,-27.4574624728109],[-58.8256442162524,-27.4573336080421],[-58.8254564168503,-27.4572909613563],[-58.8254286873111,-27.4571424660941],[-58.8253122605828,-27.4571349705355],[-58.8252768715805,-27.4571354344146],[-58.82520178083,-27.4571815273968],[-58.8250147245755,-27.4571839790829],[-58.8248322039976,-27.4571547949696],[-58.8247606833121,-27.4571106234784],[-58.8246642561343,-27.4570893326766],[-58.8246070854224,-27.4569953534623],[-58.8244496203104,-27.4569523079068],[-58.8242812274922,-27.4568597857177],[-58.8241891880034,-27.4567978392281],[-58.8239864459845,-27.4567689188713],[-58.8237776093665,-27.456676925792],[-58.8235173270154,-27.4565314755794],[-58.8231911748677,-27.456377865527],[-58.8230121534944,-27.4562539047496],[-58.822828522082,-27.4561570693284],[-58.822650910795,-27.4561187962523],[-58.8224265390029,-27.4560044500023],[-58.8223679492567,-27.4561315213113],[-58.8223400758804,-27.4559740053814],[-58.8222180758052,-27.4559350039742],[-58.8221268538783,-27.4559226649974],[-58.821970132583,-27.4559247155838],[-58.8218381699086,-27.4558948659396],[-58.8217210773213,-27.455846778127],[-58.8215643560978,-27.4558488282517],[-58.8214776709224,-27.4558048533507],[-58.8213157459736,-27.4557979495014]]]}"
20,311,383,694,255,276,6.92,100,"{""type"":""Polygon"",""coordinates"":[[[-58.8246355531725,-27.4614878088066],[-58.8238771871564,-27.4614977448687],[-58.8233164413737,-27.4615321543014],[-58.8216941290139,-27.4615894763393],[-58.8217169954249,-27.4623650475752],[-58.821760011749,-27.4631358441941],[-58.8218151558576,-27.463721536204],[-58.8219211565104,-27.4643246061163],[-58.8233516069766,-27.4642833254579],[-58.8233418087511,-27.4636880188113],[-58.8233163237054,-27.4630613414444],[-58.8246357507966,-27.4630350346575],[-58.8246355531725,-27.4614878088066]]]}"
21,399,461,860,364,428,8.03,107,"{""type"":""Polygon"",""coordinates"":[[[-58.8293609798551,-27.4613220536436],[-58.8272582321243,-27.4613767300566],[-58.825949533057,-27.4614390072679],[-58.8246355531725,-27.4614878088066],[-58.8246357507966,-27.4630350346575],[-58.8246628031939,-27.4637564192315],[-58.8246908264683,-27.4642296932126],[-58.8251512102433,-27.4642417021652],[-58.8253863850355,-27.464089760362],[-58.8260362166064,-27.4636301522639],[-58.8270311770453,-27.4629404694905],[-58.8273164583283,-27.4627608018716],[-58.8285416615411,-27.4619282500527],[-58.8293609798551,-27.4613220536436]]]}"
22,244,316,560,215,263,8.08,69,"{""type"":""Polygon"",""coordinates"":[[[-58.8321261571525,-27.4594317321305],[-58.8318546428578,-27.4595255216297],[-58.8317050605272,-27.4596537935596],[-58.8315243983168,-27.4597373655399],[-58.8312940735219,-27.4598757208062],[-58.8311699920912,-27.4600171893894],[-58.8309989930719,-27.4600735684636],[-58.8308198200283,-27.4602473372311],[-58.8307929137783,-27.4604551906745],[-58.8307160464253,-27.4606997879103],[-58.8306982081223,-27.4608443700378],[-58.8305373190332,-27.4609006156662],[-58.8304158325264,-27.4608931910575],[-58.8303447543074,-27.460876081984],[-58.8300749481717,-27.4610735955637],[-58.8300855811056,-27.461105031848],[-58.8300915307776,-27.461159084001],[-58.8300922012288,-27.4611996729538],[-58.8301896758294,-27.4612840981244],[-58.8297800857711,-27.4612849705195],[-58.8293609798551,-27.4613220536436],[-58.8285416615411,-27.4619282500527],[-58.828633353722,-27.462887859915],[-58.8291784146747,-27.462822058884],[-58.8299302418264,-27.4627219623053],[-58.8311668284035,-27.4625794001327],[-58.8324435591026,-27.4624182553058],[-58.8323126405906,-27.4612291114483],[-58.8322205616934,-27.4605536941744],[-58.8321261571525,-27.4594317321305]]]}"
23,283,385,668,266,362,11.43,58,"{""type"":""Polygon"",""coordinates"":[[[-58.8348484072557,-27.4604514270474],[-58.8344976974077,-27.460343276743],[-58.8342020781532,-27.4602028238284],[-58.8340438588212,-27.4601146908092],[-58.833861107781,-27.4600719892764],[-58.8338383471823,-27.4599189198705],[-58.8336040695678,-27.4598182554345],[-58.8335019113471,-27.4597564486547],[-58.833528215358,-27.4595125159167],[-58.8334547496269,-27.4593510923686],[-58.8333130421882,-27.4593439364903],[-58.833260694868,-27.4592363650802],[-58.8331180922395,-27.459175090469],[-58.8329973536628,-27.4592127668032],[-58.8327967690281,-27.4593146460788],[-58.83261982127,-27.4593169750615],[-58.8324171477352,-27.4592925772071],[-58.8323074150082,-27.459384238446],[-58.8321261571525,-27.4594317321305],[-58.8322205616934,-27.4605536941744],[-58.8323126405906,-27.4612291114483],[-58.8324435591026,-27.4624182553058],[-58.8311668284035,-27.4625794001327],[-58.831283376045,-27.4635116152694],[-58.8325454718791,-27.4633822376455],[-58.8338127692011,-27.4632618018721],[-58.8350957534495,-27.4631727238674],[-58.8349769335449,-27.4621052173148],[-58.8349222443182,-27.4615511028522],[-58.8348910650307,-27.4611951561492],[-58.8348484072557,-27.4604514270474]]]}"
24,307,409,716,284,351,5.67,126,"{""type"":""Polygon"",""coordinates"":[[[-58.8285416615411,-27.4619282500527],[-58.8273164583283,-27.4627608018716],[-58.8270311770453,-27.4629404694905],[-58.8260362166064,-27.4636301522639],[-58.8253863850355,-27.464089760362],[-58.8260322748967,-27.464004605935],[-58.8273888103207,-27.4637747970201],[-58.828060719764,-27.4637344004173],[-58.8286922560741,-27.463699041736],[-58.8299554014556,-27.4636328257165],[-58.8300058110067,-27.4636231414224],[-58.831283376045,-27.4635116152694],[-58.8311668284035,-27.4625794001327],[-58.8299302418264,-27.4627219623053],[-58.8291784146747,-27.462822058884],[-58.828633353722,-27.462887859915],[-58.8285416615411,-27.4619282500527]]]}"
25,414,482,896,400,416,5.96,150,"{""type"":""Polygon"",""coordinates"":[[[-58.8246357507966,-27.4630350346575],[-58.8233163237054,-27.4630613414444],[-58.8233418087511,-27.4636880188113],[-58.8233516069766,-27.4642833254579],[-58.8219211565104,-27.4643246061163],[-58.8219657455182,-27.4648833708168],[-58.8220615623782,-27.4654820628633],[-58.8221291217498,-27.4662074290016],[-58.8224566379684,-27.4664422181909],[-58.8225180520498,-27.4664865229385],[-58.8236895068807,-27.4654562368566],[-58.8247470312629,-27.4645717826048],[-58.8251512102433,-27.4642417021652],[-58.8246908264683,-27.4642296932126],[-58.8246628031939,-27.4637564192315],[-58.8246357507966,-27.4630350346575]]]}"
26,343,467,810,348,433,9.18,88,"{""type"":""Polygon"",""coordinates"":[[[-58.8273888103207,-27.4637747970201],[-58.8260322748967,-27.464004605935],[-58.8253863850355,-27.464089760362],[-58.8251512102433,-27.4642417021652],[-58.8247470312629,-27.4645717826048],[-58.8236895068807,-27.4654562368566],[-58.8225180520498,-27.4664865229385],[-58.8225645207714,-27.466544555925],[-58.8225961925425,-27.4666253369634],[-58.8225964151629,-27.4666388666604],[-58.8227976166563,-27.4665730802725],[-58.8237773683244,-27.4664925858304],[-58.8250500686912,-27.4663902010478],[-58.8263679724369,-27.4662691682374],[-58.8270039850696,-27.4661976710626],[-58.8275944929275,-27.4661267683746],[-58.8275076380296,-27.4651535619136],[-58.827411345968,-27.4645278156821],[-58.8273658371307,-27.4639149353667],[-58.8273888103207,-27.4637747970201]]]}"
27,307,367,674,280,318,6.78,99,"{""type"":""Polygon"",""coordinates"":[[[-58.8300058110067,-27.4636231414224],[-58.8299554014556,-27.4636328257165],[-58.8286922560741,-27.463699041736],[-58.828060719764,-27.4637344004173],[-58.8273888103207,-27.4637747970201],[-58.8273658371307,-27.4639149353667],[-58.827411345968,-27.4645278156821],[-58.8275076380296,-27.4651535619136],[-58.8275944929275,-27.4661267683746],[-58.8289938060094,-27.4660362181993],[-58.8302661953393,-27.4659157466718],[-58.8301031805987,-27.4649255003899],[-58.8300058110067,-27.4636231414224]]]}"
28,375,519,894,290,427,13,69,"{""type"":""Polygon"",""coordinates"":[[[-58.8350957534495,-27.4631727238674],[-58.8338127692011,-27.4632618018721],[-58.8325454718791,-27.4633822376455],[-58.831283376045,-27.4635116152694],[-58.8300058110067,-27.4636231414224],[-58.8301031805987,-27.4649255003899],[-58.8302661953393,-27.4659157466718],[-58.8315388794663,-27.4658133031513],[-58.8328414484534,-27.4656833894968],[-58.8341136780585,-27.4655538634437],[-58.8353459049409,-27.4654519183278],[-58.8352319852853,-27.464375326176],[-58.8350957534495,-27.4631727238674]]]}"
29,292,395,687,258,346,10.92,63,"{""type"":""Polygon"",""coordinates"":[[[-58.8353459049409,-27.4654519183278],[-58.8341136780585,-27.4655538634437],[-58.8328414484534,-27.4656833894968],[-58.8315388794663,-27.4658133031513],[-58.8316527657369,-27.4668898998004],[-58.8317989303746,-27.4680833536698],[-58.8330711891915,-27.4679538357815],[-58.8344094715286,-27.4678414797935],[-58.8344097702946,-27.4678595192672],[-58.834532679337,-27.468868330526],[-58.8357140825896,-27.468749007234],[-58.8355857333241,-27.4677177148612],[-58.8354606494823,-27.4665781186525],[-58.8353459049409,-27.4654519183278]]]}"
30,270,362,632,236,312,7.89,80,"{""type"":""Polygon"",""coordinates"":[[[-58.8315388794663,-27.4658133031513],[-58.8302661953393,-27.4659157466718],[-58.8289938060094,-27.4660362181993],[-58.8275944929275,-27.4661267683746],[-58.8277228270718,-27.4662423660668],[-58.8278238114686,-27.4671522345712],[-58.829122240279,-27.4670765397505],[-58.8292083011971,-27.4683068738541],[-58.8304758091213,-27.4681954853766],[-58.8317989303746,-27.4680833536698],[-58.8316527657369,-27.4668898998004],[-58.8315388794663,-27.4658133031513]]]}"
31,265,316,581,206,298,6.52,89,"{""type"":""Polygon"",""coordinates"":[[[-58.8275944929275,-27.4661267683746],[-58.8270039850696,-27.4661976710626],[-58.8263679724369,-27.4662691682374],[-58.8250500686912,-27.4663902010478],[-58.8251925201427,-27.467362680734],[-58.8253296191695,-27.468623925633],[-58.8266124537868,-27.4685213928761],[-58.8278650232604,-27.4684237566153],[-58.8278238114686,-27.4671522345712],[-58.8277228270718,-27.4662423660668],[-58.8275944929275,-27.4661267683746]]]}"
32,435,560,995,428,603,7.07,141,"{""type"":""Polygon"",""coordinates"":[[[-58.8224566379684,-27.4664422181909],[-58.8223754451081,-27.4664252375453],[-58.822269194832,-27.466422117449],[-58.8221584078713,-27.4664506327482],[-58.8220326753772,-27.4664928761764],[-58.8219676149014,-27.4665343254868],[-58.8218976467203,-27.4665848607366],[-58.8218728117215,-27.4666122509697],[-58.8218480508869,-27.4666441510998],[-58.8218135488804,-27.4666987330575],[-58.8217940665531,-27.4667440967188],[-58.8217795660588,-27.4667848843147],[-58.8217702699261,-27.4668346255495],[-58.8217765869113,-27.4669112277031],[-58.8217930159707,-27.4669876975291],[-58.8218652097915,-27.4670724593384],[-58.8219674432234,-27.4671387844868],[-58.8225858281863,-27.467532157571],[-58.8227798512019,-27.4688738563717],[-58.8240472270928,-27.4687535060412],[-58.8253296191695,-27.468623925633],[-58.8251925201427,-27.467362680734],[-58.8250500686912,-27.4663902010478],[-58.8237773683244,-27.4664925858304],[-58.8227976166563,-27.4665730802725],[-58.8225964151629,-27.4666388666604],[-58.8225961925425,-27.4666253369634],[-58.8225645207714,-27.466544555925],[-58.8225180520498,-27.4664865229385],[-58.8224566379684,-27.4664422181909]]]}"
33,286,364,650,293,405,6.35,102,"{""type"":""Polygon"",""coordinates"":[[[-58.8253296191695,-27.468623925633],[-58.8240472270928,-27.4687535060412],[-58.8227798512019,-27.4688738563717],[-58.8229303870054,-27.4700311783949],[-58.8230701460841,-27.4711480433035],[-58.824337101634,-27.4710006297634],[-58.8255996660007,-27.4708938601565],[-58.8254598077011,-27.4697724890873],[-58.8253296191695,-27.468623925633]]]}"
34,322,359,681,291,418,6.31,108,"{""type"":""Polygon"",""coordinates"":[[[-58.8278650232604,-27.4684237566153],[-58.8266124537868,-27.4685213928761],[-58.8253296191695,-27.468623925633],[-58.8254598077011,-27.4697724890873],[-58.8255996660007,-27.4708938601565],[-58.8268718188591,-27.4707553772994],[-58.8281543779724,-27.4706347896894],[-58.8279991027455,-27.469500091927],[-58.8278650232604,-27.4684237566153]]]}"
35,443,509,952,340,518,11.4,84,"{""type"":""Polygon"",""coordinates"":[[[-58.8317989303746,-27.4680833536698],[-58.8304758091213,-27.4681954853766],[-58.8292083011971,-27.4683068738541],[-58.829122240279,-27.4670765397505],[-58.8278238114686,-27.4671522345712],[-58.8278650232604,-27.4684237566153],[-58.8279991027455,-27.469500091927],[-58.8281543779724,-27.4706347896894],[-58.8294470459151,-27.470514057494],[-58.8307700472761,-27.4703929144483],[-58.8320525957614,-27.4702722913118],[-58.8319372082212,-27.4691054983699],[-58.8317989303746,-27.4680833536698]]]}"
36,204,235,439,154,250,7.76,57,"{""type"":""Polygon"",""coordinates"":[[[-58.8357140825896,-27.468749007234],[-58.834532679337,-27.468868330526],[-58.8344097702946,-27.4678595192672],[-58.8344094715286,-27.4678414797935],[-58.8330711891915,-27.4679538357815],[-58.8317989303746,-27.4680833536698],[-58.8319372082212,-27.4691054983699],[-58.8320525957614,-27.4702722913118],[-58.8333450290523,-27.4701379937001],[-58.8346676458552,-27.4699942646812],[-58.8358391728553,-27.4698886026299],[-58.8357140825896,-27.468749007234]]]}"
37,594,628,1222,272,262,6.71,182,"{""type"":""Polygon"",""coordinates"":[[[-58.8213157459736,-27.4557979495014],[-58.8212408025517,-27.4558530602099],[-58.8212676366698,-27.4559474377106],[-58.8211521747575,-27.4559985674194],[-58.821056490207,-27.4560223731312],[-58.8210531392183,-27.456126167167],[-58.8210236953081,-27.4561806827544],[-58.8209926950898,-27.4561404902306],[-58.8209871207944,-27.4561089869716],[-58.8209767132896,-27.4560910795513],[-58.8209561947173,-27.4560733043477],[-58.8209306947223,-27.4560601051585],[-58.8209056393608,-27.4560739654249],[-58.820886010049,-27.4561103091318],[-58.8208713621605,-27.4561420768205],[-58.820858196327,-27.4562640427105],[-58.820838641072,-27.4563048963222],[-58.8207985672051,-27.4563279747065],[-58.8207733635669,-27.4563328151319],[-58.8207483081244,-27.4563466753734],[-58.8207274190459,-27.4563063505853],[-58.8207367150566,-27.456256609369],[-58.8207509925037,-27.4562022921403],[-58.8207500292212,-27.4561436633048],[-58.8207595475087,-27.4561074518184],[-58.8207741213268,-27.4560711742295],[-58.8207736026321,-27.4560396048564],[-58.8207727875423,-27.4559899958412],[-58.8207417874692,-27.4559498032535],[-58.8206956208328,-27.4559098089549],[-58.8206217315487,-27.4557213180594],[-58.8205255284809,-27.4557135540225],[-58.8203743073539,-27.4557425961764],[-58.8203508076912,-27.4558511644882],[-58.8202458268529,-27.4559247108475],[-58.8201649383582,-27.4559257681445],[-58.8200638277336,-27.4559270896998],[-58.8199932724936,-27.4559415444822],[-58.8199107545751,-27.4558433835535],[-58.8198353660155,-27.4558714340633],[-58.819838254387,-27.4560473206647],[-58.8198334950934,-27.4560654263839],[-58.8196978101625,-27.4561168191941],[-58.8195921621557,-27.4561497758715],[-58.8194966251711,-27.4561826003602],[-58.8193851070121,-27.4561660138904],[-58.8193445886165,-27.4561620323852],[-58.8191174592738,-27.4561875540377],[-58.8190118110013,-27.456220510286],[-58.8189370141346,-27.4562846396503],[-58.8188819212351,-27.4563169354386],[-58.8187952366449,-27.4562729588358],[-58.8186988851157,-27.456256173723],[-58.8187377304494,-27.4567744178128],[-58.8187433781747,-27.4568104311036],[-58.8187619498218,-27.4570176891002],[-58.8188478509473,-27.4576300469812],[-58.8189318069058,-27.4584318871227],[-58.8202091815845,-27.4583114451007],[-58.8205070938216,-27.4582849961313],[-58.8208050058779,-27.4582585465311],[-58.8208403212181,-27.4582535738619],[-58.8215773317096,-27.4581762713513],[-58.8215348993467,-27.4577482931055],[-58.8215186349696,-27.4573741030421],[-58.8214824596868,-27.4567114772224],[-58.8214816442564,-27.4566618682316],[-58.8214207700632,-27.4563423921347],[-58.8213157459736,-27.4557979495014]]]}"
38,529,557,1086,288,276,6.63,164,"{""type"":""Polygon"",""coordinates"":[[[-58.8215773317096,-27.4581762713513],[-58.8208403212181,-27.4582535738619],[-58.8208050058779,-27.4582585465311],[-58.8205070938216,-27.4582849961313],[-58.8202091815845,-27.4583114451007],[-58.8189318069058,-27.4584318871227],[-58.8190194133987,-27.4591479726781],[-58.8191123731921,-27.4598820316521],[-58.8203899864885,-27.4597751169202],[-58.8205013097135,-27.4607029021961],[-58.8205191446922,-27.460865060577],[-58.8205707067834,-27.4615410178892],[-58.8205418542115,-27.4616316126752],[-58.8216941290139,-27.4615894763393],[-58.8216317618516,-27.4596415941352],[-58.8216161035597,-27.4589967436898],[-58.8215983556522,-27.4585323555872],[-58.8215773317096,-27.4581762713513]]]}"
39,794,883,1677,442,509,31.67,53,"{""type"":""Polygon"",""coordinates"":[[[-58.8186988851157,-27.456256173723],[-58.8185217928299,-27.456249464728],[-58.818381051439,-27.4563009223145],[-58.8182595701621,-27.4562934868049],[-58.8180931068523,-27.4563182146616],[-58.8179426239606,-27.4563923534149],[-58.8178579371521,-27.4564701439858],[-58.8177322138791,-27.4565123831155],[-58.8174598790558,-27.4565565357148],[-58.8173138592738,-27.4565945284896],[-58.8171621921787,-27.4565965077351],[-58.8171479868639,-27.4566553345999],[-58.8170425593248,-27.4567018191595],[-58.8167951318754,-27.4567230910509],[-58.8165935002363,-27.4567618086305],[-58.816426074716,-27.4567279055736],[-58.8162444434768,-27.4567528291059],[-58.8160641425218,-27.4568589309968],[-58.8157316562123,-27.4569354409248],[-58.8156784832576,-27.4570849934902],[-58.8156714756599,-27.4572745420743],[-58.8156741359087,-27.4574368992806],[-58.8157678712375,-27.4576025798081],[-58.8156536304037,-27.4580371144512],[-58.815469822868,-27.458237989971],[-58.8154600071283,-27.4582561614886],[-58.8150128289812,-27.4587401448763],[-58.8149829381702,-27.4587675998053],[-58.8148580236281,-27.4588594456627],[-58.8141634801878,-27.4593692047629],[-58.8136959571398,-27.4595376871576],[-58.813205810883,-27.4598688545976],[-58.8128370733611,-27.4602029506656],[-58.8123884397165,-27.4602899869098],[-58.8120034649611,-27.4602498884133],[-58.8118616826711,-27.4602382007528],[-58.8119280639158,-27.4608959268137],[-58.8119743369567,-27.4612516848864],[-58.8120275102014,-27.4617201253338],[-58.8120906481636,-27.4621794142524],[-58.813539237055,-27.4620116944933],[-58.8143469136398,-27.4619244870537],[-58.814977709025,-27.4618440916739],[-58.8153918424546,-27.4618116273768],[-58.8157807704293,-27.4617840014474],[-58.8165893301685,-27.4617509001698],[-58.8174435393283,-27.4617262201131],[-58.817913728959,-27.4617200819124],[-58.819222958854,-27.4616894492625],[-58.8205418542115,-27.4616316126752],[-58.8205707067834,-27.4615410178892],[-58.8205191446922,-27.460865060577],[-58.8205013097135,-27.4607029021961],[-58.8203899864885,-27.4597751169202],[-58.8191123731921,-27.4598820316521],[-58.8190194133987,-27.4591479726781],[-58.8189318069058,-27.4584318871227],[-58.8188478509473,-27.4576300469812],[-58.8187619498218,-27.4570176891002],[-58.8187433781747,-27.4568104311036],[-58.8187377304494,-27.4567744178128],[-58.8186988851157,-27.456256173723]]]}"
40,1183,1097,2280,485,451,20.07,114,"{""type"":""Polygon"",""coordinates"":[[[-58.8118616826711,-27.4602382007528],[-58.8115881559176,-27.460210183508],[-58.8112872861891,-27.4600562164711],[-58.8109553024098,-27.4601642851058],[-58.8105605853557,-27.460146863746],[-58.8101472663105,-27.4602289227198],[-58.8098947731954,-27.460250248505],[-58.8097106566715,-27.4604330773006],[-58.8095307114452,-27.4605617209455],[-58.8093002080076,-27.4606910213425],[-58.80903247261,-27.4607080327707],[-58.8088828119466,-27.4611430229105],[-58.8089421324584,-27.4616790485429],[-58.8089817205675,-27.4619356551105],[-58.8090095034849,-27.4620886644993],[-58.8090954303367,-27.4627055403316],[-58.8091591462212,-27.4632009105586],[-58.8092376622879,-27.4636735339241],[-58.8092443385955,-27.4637726867799],[-58.8092958080833,-27.4641374001288],[-58.8093189045204,-27.4643130247347],[-58.8093643610442,-27.4646191745772],[-58.8094005630474,-27.4646683238927],[-58.8094529913115,-27.4650916662229],[-58.8095711755277,-27.4658254052383],[-58.8096236512374,-27.4659420062927],[-58.8096787058442,-27.46621645493],[-58.8096346751353,-27.4663072450521],[-58.8097863672753,-27.4672345163346],[-58.8102168707291,-27.4672740281068],[-58.810753846937,-27.467330197261],[-58.8109969073332,-27.4673495900581],[-58.8108445413687,-27.4663817312497],[-58.8107888939967,-27.4660712037917],[-58.8107283384243,-27.4657697619008],[-58.8113488996758,-27.465680493485],[-58.8119797930671,-27.4656046205209],[-58.8126003520529,-27.465515346616],[-58.8125311201885,-27.4649929852005],[-58.8123387795454,-27.4637459735083],[-58.8122424267267,-27.4631111925862],[-58.8122198424591,-27.4629671381408],[-58.8121639722527,-27.4626430814084],[-58.8120906481636,-27.4621794142524],[-58.8120275102014,-27.4617201253338],[-58.8119743369567,-27.4612516848864],[-58.8119280639158,-27.4608959268137],[-58.8118616826711,-27.4602382007528]]]}"
41,807,809,1616,409,383,8.67,186,"{""type"":""Polygon"",""coordinates"":[[[-58.8089817205675,-27.4619356551105],[-58.8088986917825,-27.4618059179219],[-58.8086554228865,-27.4617729910285],[-58.8083123625051,-27.4618225558655],[-58.808016938655,-27.4620023172323],[-58.8079769334997,-27.4620299020746],[-58.8079468192257,-27.4620438257914],[-58.8079169993239,-27.462075789257],[-58.807887400187,-27.4621212825331],[-58.8078734101388,-27.4621936384958],[-58.8078490875868,-27.4622525959344],[-58.8078345823549,-27.4622933823224],[-58.8078104069463,-27.4623613596331],[-58.807796269644,-27.462424695712],[-58.8077964904178,-27.4624382255284],[-58.8074433893257,-27.4624924295663],[-58.807312672515,-27.4625392353441],[-58.8073237613549,-27.4629089847801],[-58.807490016929,-27.4628707394128],[-58.8076120939776,-27.4629142635136],[-58.8076300579088,-27.4630854442712],[-58.8075400084138,-27.4631452549756],[-58.807607228342,-27.4635458518591],[-58.8076344947956,-27.4636672919922],[-58.8077344576839,-27.463905071483],[-58.8077651612362,-27.4639272272934],[-58.8078017302917,-27.4639989267637],[-58.8078487056652,-27.4640885346713],[-58.8077932375393,-27.4640982766915],[-58.8073462020758,-27.4642845162367],[-58.8077902356089,-27.4651538646408],[-58.8080044502755,-27.4655751068274],[-58.8083330650266,-27.4661888310469],[-58.8085575433218,-27.4666189606472],[-58.8088243868442,-27.4671658225063],[-58.8094167579698,-27.4672077444526],[-58.8097863672753,-27.4672345163346],[-58.8096346751353,-27.4663072450521],[-58.8096787058442,-27.46621645493],[-58.8096236512374,-27.4659420062927],[-58.8095711755277,-27.4658254052383],[-58.8094529913115,-27.4650916662229],[-58.8094005630474,-27.4646683238927],[-58.8093643610442,-27.4646191745772],[-58.8093189045204,-27.4643130247347],[-58.8092958080833,-27.4641374001288],[-58.8092443385955,-27.4637726867799],[-58.8092376622879,-27.4636735339241],[-58.8091591462212,-27.4632009105586],[-58.8090954303367,-27.4627055403316],[-58.8090095034849,-27.4620886644993],[-58.8089817205675,-27.4619356551105]]]}"
52,562,661,1223,334,309,12.51,98,"{""type"":""Polygon"",""coordinates"":[[[-58.813539237055,-27.4620116944933],[-58.8120906481636,-27.4621794142524],[-58.8121639722527,-27.4626430814084],[-58.8122198424591,-27.4629671381408],[-58.8122424267267,-27.4631111925862],[-58.8123387795454,-27.4637459735083],[-58.8125311201885,-27.4649929852005],[-58.8126003520529,-27.465515346616],[-58.8119797930671,-27.4656046205209],[-58.8113488996758,-27.465680493485],[-58.8107283384243,-27.4657697619008],[-58.8107888939967,-27.4660712037917],[-58.8108445413687,-27.4663817312497],[-58.8109969073332,-27.4673495900581],[-58.8118327829234,-27.4674379535446],[-58.8130074907761,-27.4675264106396],[-58.8139896995142,-27.4675948117457],[-58.8143935949112,-27.4675534613121],[-58.8142420116243,-27.4666352168205],[-58.814129442388,-27.4659374968759],[-58.8139487443133,-27.4647850651191],[-58.8137722205585,-27.4635784478224],[-58.8137018036331,-27.4629839282823],[-58.8136682936423,-27.4627903967177],[-58.813539237055,-27.4620116944933]]]}"
53,835,903,1738,502,417,16.82,103,"{""type"":""Polygon"",""coordinates"":[[[-58.8165893301685,-27.4617509001698],[-58.8157807704293,-27.4617840014474],[-58.8153918424546,-27.4618116273768],[-58.814977709025,-27.4618440916739],[-58.8143469136398,-27.4619244870537],[-58.813539237055,-27.4620116944933],[-58.8136682936423,-27.4627903967177],[-58.8137018036331,-27.4629839282823],[-58.8137722205585,-27.4635784478224],[-58.8139487443133,-27.4647850651191],[-58.814129442388,-27.4659374968759],[-58.8142420116243,-27.4666352168205],[-58.8143935949112,-27.4675534613121],[-58.8160438258119,-27.4673424871655],[-58.8168257400649,-27.4672240239912],[-58.8167965173027,-27.4663673383843],[-58.8167592544847,-27.4656370622058],[-58.8166948163487,-27.4644831177998],[-58.8166349924433,-27.4633020476527],[-58.8165893301685,-27.4617509001698]]]}"
54,343,383,726,256,262,7.86,92,"{""type"":""Polygon"",""coordinates"":[[[-58.819222958854,-27.4616894492625],[-58.817913728959,-27.4617200819124],[-58.8174435393283,-27.4617262201131],[-58.8165893301685,-27.4617509001698],[-58.8166349924433,-27.4633020476527],[-58.8166948163487,-27.4644831177998],[-58.8180037098375,-27.4644299454666],[-58.8193380290484,-27.4643854503614],[-58.8192780290138,-27.4631953628819],[-58.8192455118169,-27.4624469820935],[-58.819222958854,-27.4616894492625]]]}"
73,354,382,736,249,317,10.16,72,"{""type"":""Polygon"",""coordinates"":[[[-58.7866427613246,-27.4614662619178],[-58.7859183894394,-27.4613898472894],[-58.7856955674444,-27.4613701504768],[-58.7849611574602,-27.4612983704801],[-58.7847912062876,-27.4620493630432],[-58.78461823134,-27.4629267001235],[-58.7844277614655,-27.4636599115461],[-58.7856508327261,-27.4639284191227],[-58.7862500575996,-27.4640831258973],[-58.7868234220431,-27.4642020745315],[-58.7874410954227,-27.4651865489485],[-58.7882535570038,-27.4653926399719],[-58.7890101861867,-27.4655859108321],[-58.7893093678056,-27.4656361970804],[-58.7891953664045,-27.4654662472631],[-58.7886296198169,-27.4645668216773],[-58.7879818225194,-27.4635962723257],[-58.7873125035464,-27.4625447990857],[-58.7866427613246,-27.4614662619178]]]}"
74,466,525,991,328,260,12.57,79,"{""type"":""Polygon"",""coordinates"":[[[-58.7796291990729,-27.46086139649],[-58.7790221325888,-27.4608465994085],[-58.7788603703418,-27.4614801971771],[-58.7786799032495,-27.4622087633732],[-58.7792994069148,-27.4623677526743],[-58.7799085829495,-27.4625133383724],[-58.7806652527955,-27.4627111663154],[-58.7810357147033,-27.4627921356865],[-58.7821783097203,-27.4630887694503],[-58.7833158543711,-27.4633854582885],[-58.7844277614655,-27.4636599115461],[-58.78461823134,-27.4629267001235],[-58.7847912062876,-27.4620493630432],[-58.7849611574602,-27.4612983704801],[-58.7842722510554,-27.4612260034733],[-58.7839836305631,-27.461202636125],[-58.7836190268632,-27.4611712196635],[-58.7829456522253,-27.4611212017196],[-58.7826873673514,-27.4610974432132],[-58.7822769711307,-27.4610485657583],[-58.7818569711817,-27.4610313865045],[-58.7815786081897,-27.4610169047278],[-58.7810413083311,-27.4609380707463],[-58.780323012469,-27.4609247020753],[-58.7796291990729,-27.46086139649]]]}"
42,532,558,1090,293,252,14.99,73,"{""type"":""Polygon"",""coordinates"":[[[-58.8098947731954,-27.460250248505],[-58.8094228937466,-27.4601526308024],[-58.8084825232058,-27.4601648476501],[-58.8078987561945,-27.460028079822],[-58.8069272968497,-27.4596843289055],[-58.8064349047938,-27.4595689234741],[-58.8061135598581,-27.4600196709178],[-58.8060484397571,-27.4603678547361],[-58.8060437515513,-27.4603904700356],[-58.8061845215873,-27.4606502761485],[-58.8063497624948,-27.4608601447568],[-58.8064750903615,-27.4614133591434],[-58.806389214954,-27.4614189841715],[-58.806388626708,-27.4613829046276],[-58.80636246526,-27.4613291132664],[-58.8062916103046,-27.4613255215725],[-58.806260319579,-27.461267285833],[-58.806228955364,-27.461204540141],[-58.8061776620391,-27.4611600965494],[-58.806116624735,-27.4611383338184],[-58.8060709754264,-27.4611299041537],[-58.8060048823503,-27.4611082069512],[-58.8059542507658,-27.4611043527684],[-58.805898416357,-27.4610915442514],[-58.8058274145409,-27.4610789324239],[-58.8057818387784,-27.4610750126067],[-58.8057417598449,-27.461098086876],[-58.8057017543963,-27.4611256710794],[-58.8056718605477,-27.4611531241423],[-58.8057027099228,-27.4611843003624],[-58.8057438179488,-27.461224365329],[-58.8057696850549,-27.4612601170446],[-58.805785734569,-27.4613140396719],[-58.8058168045441,-27.4613587456958],[-58.8058124102899,-27.4613994007664],[-58.8057728457906,-27.4614540446602],[-58.8057583398676,-27.4614948308682],[-58.8057033873151,-27.4615361416172],[-58.8056433053909,-27.4615730079666],[-58.8057452305314,-27.4616213060199],[-58.8057232590821,-27.4618245813611],[-58.8056842089233,-27.4619107948468],[-58.8056351205117,-27.4620016493995],[-58.8055854440215,-27.4620564243812],[-58.8055754793178,-27.4620655753978],[-58.8055002295093,-27.4621026383888],[-58.8054550942982,-27.462125778154],[-58.8054053441699,-27.4621760431325],[-58.8053130308477,-27.4624072958943],[-58.8052343415648,-27.4625436431025],[-58.8052251851468,-27.4626024034932],[-58.8052624869981,-27.4627192031939],[-58.8052885013131,-27.462763974872],[-58.8054007597004,-27.4628256718481],[-58.8054719096089,-27.4628473037273],[-58.8058263363121,-27.4628742835753],[-58.8060734131119,-27.4628304807215],[-58.8060885072454,-27.4628257740279],[-58.8061547484325,-27.4628564910207],[-58.8062481073388,-27.4629996285921],[-58.8063002104431,-27.4630936814675],[-58.8063816930777,-27.463128711505],[-58.8064296964539,-27.4632814591594],[-58.8063704963116,-27.4633724451488],[-58.8063614139952,-27.4634357155237],[-58.8064099322721,-27.4636200327641],[-58.8059327810714,-27.46382019121],[-58.8063715986476,-27.4646805905208],[-58.8068206089404,-27.4655453667246],[-58.8070348208563,-27.4659666105228],[-58.8072491080608,-27.4663923638259],[-58.8076306373201,-27.4671497513244],[-58.8082375874583,-27.4671554018878],[-58.8088243868442,-27.4671658225063],[-58.8085575433218,-27.4666189606472],[-58.8083330650266,-27.4661888310469],[-58.8080044502755,-27.4655751068274],[-58.8077902356089,-27.4651538646408],[-58.8073462020758,-27.4642845162367],[-58.8077932375393,-27.4640982766915],[-58.8078487056652,-27.4640885346713],[-58.8078017302917,-27.4639989267637],[-58.8077651612362,-27.4639272272934],[-58.8077344576839,-27.463905071483],[-58.8076344947956,-27.4636672919922],[-58.807607228342,-27.4635458518591],[-58.8075400084138,-27.4631452549756],[-58.8076300579088,-27.4630854442712],[-58.8076120939776,-27.4629142635136],[-58.807490016929,-27.4628707394128],[-58.8073237613549,-27.4629089847801],[-58.807312672515,-27.4625392353441],[-58.8074433893257,-27.4624924295663],[-58.8077964904178,-27.4624382255284],[-58.807796269644,-27.462424695712],[-58.8078104069463,-27.4623613596331],[-58.8078345823549,-27.4622933823224],[-58.8078490875868,-27.4622525959344],[-58.8078734101388,-27.4621936384958],[-58.807887400187,-27.4621212825331],[-58.8079169993239,-27.462075789257],[-58.8079468192257,-27.4620438257914],[-58.8079769334997,-27.4620299020746],[-58.808016938655,-27.4620023172323],[-58.8083123625051,-27.4618225558655],[-58.8086554228865,-27.4617729910285],[-58.8088986917825,-27.4618059179219],[-58.8089817205675,-27.4619356551105],[-58.8089421324584,-27.4616790485429],[-58.8088828119466,-27.4611430229105],[-58.80903247261,-27.4607080327707],[-58.8093002080076,-27.4606910213425],[-58.8095307114452,-27.4605617209455],[-58.8097106566715,-27.4604330773006],[-58.8098947731954,-27.460250248505]]]}"
43,531,567,1098,255,226,6.88,160,"{""type"":""Polygon"",""coordinates"":[[[-58.8056433053909,-27.4615730079666],[-58.8056035202499,-27.4616141219837],[-58.8055635145857,-27.4616417061559],[-58.8055232884123,-27.4616557604827],[-58.8054783738667,-27.4616924300829],[-58.8054576360694,-27.4616611227025],[-58.8054772714494,-27.4616247809066],[-58.8055224799538,-27.4616061510878],[-58.8055625591142,-27.4615830768722],[-58.8056024177599,-27.4615464728113],[-58.8056472587048,-27.4615052932304],[-58.8057020642589,-27.4614549626138],[-58.8057416287947,-27.4614003187384],[-58.8056853532417,-27.4613604504741],[-58.8056247569054,-27.461365747198],[-58.805579548516,-27.4613843770451],[-58.8055393224364,-27.4613984313723],[-58.8054985818843,-27.461380916072],[-58.805467805999,-27.4613542497526],[-58.8053973184802,-27.46137320733],[-58.8053417779369,-27.461378438376],[-58.8052707759811,-27.4613658262708],[-58.8052299619957,-27.4613438009432],[-58.8051793303129,-27.4613399464825],[-58.8051343422888,-27.4613721060265],[-58.8051044482294,-27.4613995589766],[-58.8050647364144,-27.4614451827935],[-58.8050199687398,-27.4614908721426],[-58.8049695574119,-27.4615005474479],[-58.8049189991317,-27.4615012028421],[-58.8048532733648,-27.4615020548272],[-58.8047983939162,-27.461547875182],[-58.8047580942008,-27.4615574193439],[-58.80471259172,-27.4615580091316],[-58.8046721450692,-27.4615585333748],[-58.8046320657163,-27.4615816073426],[-58.8045867835964,-27.4615957269316],[-58.8045412810955,-27.461596316664],[-58.8044706463314,-27.4616062538914],[-58.8044048470353,-27.46160259572],[-58.8043388273979,-27.4615854076735],[-58.8042778636122,-27.4615681540794],[-58.8042372700606,-27.4615596583001],[-58.8041766000672,-27.4615604444535],[-58.8041256011028,-27.46153403987],[-58.8040896962166,-27.4615029287936],[-58.8040540850945,-27.4614898575017],[-58.8040183271113,-27.4614677663026],[-58.8039927542319,-27.4614500540333],[-58.8039416084972,-27.4614146294794],[-58.8038076710735,-27.4615742462166],[-58.8038139751604,-27.4616508498556],[-58.8038661489777,-27.4617494137389],[-58.8038888689772,-27.461902489998],[-58.8039109281648,-27.4620149767085],[-58.8038774463801,-27.4621326938943],[-58.8038246956487,-27.4623093024109],[-58.8037271027111,-27.4625270899353],[-58.8036602956788,-27.4630827960894],[-58.8035760545185,-27.4638101422229],[-58.8035007599447,-27.464776450041],[-58.8038603955337,-27.4648123890146],[-58.8041491006394,-27.4648402244232],[-58.804665031189,-27.4648470704813],[-58.8044561068393,-27.4644392867415],[-58.8049632319256,-27.4642161901213],[-58.8054505721269,-27.4640204136611],[-58.8059327810714,-27.46382019121],[-58.8064099322721,-27.4636200327641],[-58.8063614139952,-27.4634357155237],[-58.8063704963116,-27.4633724451488],[-58.8064296964539,-27.4632814591594],[-58.8063816930777,-27.463128711505],[-58.8063002104431,-27.4630936814675],[-58.8062481073388,-27.4629996285921],[-58.8061547484325,-27.4628564910207],[-58.8060885072454,-27.4628257740279],[-58.8060734131119,-27.4628304807215],[-58.8058263363121,-27.4628742835753],[-58.8054719096089,-27.4628473037273],[-58.8054007597004,-27.4628256718481],[-58.8052885013131,-27.462763974872],[-58.8052624869981,-27.4627192031939],[-58.8052251851468,-27.4626024034932],[-58.8052343415648,-27.4625436431025],[-58.8053130308477,-27.4624072958943],[-58.8054053441699,-27.4621760431325],[-58.8054550942982,-27.462125778154],[-58.8055002295093,-27.4621026383888],[-58.8055754793178,-27.4620655753978],[-58.8055854440215,-27.4620564243812],[-58.8056351205117,-27.4620016493995],[-58.8056842089233,-27.4619107948468],[-58.8057232590821,-27.4618245813611],[-58.8057452305314,-27.4616213060199],[-58.8056433053909,-27.4615730079666]]]}"
44,632,605,1237,311,281,30.92,40,"{""type"":""Polygon"",""coordinates"":[[[-58.8064349047938,-27.4595689234741],[-58.8059831065363,-27.4594620115647],[-58.8054381013878,-27.4592209797223],[-58.8047475846718,-27.4590494952048],[-58.8042633993618,-27.4588166920908],[-58.8039288415604,-27.4587668958644],[-58.8038811375954,-27.4586321867969],[-58.8035796213257,-27.4584376127755],[-58.8031694414779,-27.4580910745072],[-58.8026554430298,-27.4578902278865],[-58.8021270128248,-27.4577346751194],[-58.8015038428335,-27.4573502897688],[-58.8010382079703,-27.4570134840205],[-58.8009359225611,-27.4569426323896],[-58.8010375503134,-27.4572841469519],[-58.8011267949833,-27.4574859834636],[-58.8011647502862,-27.4576433742612],[-58.8010611469522,-27.4578025960424],[-58.8009427427882,-27.4579845637112],[-58.8007692387287,-27.4581988202041],[-58.8007019036914,-27.4584117035951],[-58.8006788971628,-27.4585518392179],[-58.800752975211,-27.4587538720516],[-58.8008069772475,-27.4589651862804],[-58.8008113017413,-27.4592312738238],[-58.8006935554041,-27.4594538309637],[-58.800585700261,-27.4596627273902],[-58.8005833587514,-27.4604521662265],[-58.8006290822436,-27.460776360154],[-58.8005625532739,-27.461350105481],[-58.8005995566,-27.4614488668789],[-58.8006110608974,-27.4615344253041],[-58.8005374220677,-27.4616707047391],[-58.800464370645,-27.4621543162352],[-58.8003945435106,-27.4628363658016],[-58.8003248623489,-27.4635274352241],[-58.8001451967919,-27.464919116794],[-58.8009097519806,-27.4649768927418],[-58.8017554237474,-27.465047147428],[-58.8018043644197,-27.4646360220245],[-58.8023663852235,-27.4646783673687],[-58.8026498870312,-27.4646972514752],[-58.8032729471022,-27.4647613572999],[-58.8035007599447,-27.464776450041],[-58.8035760545185,-27.4638101422229],[-58.8036602956788,-27.4630827960894],[-58.8037271027111,-27.4625270899353],[-58.8038246956487,-27.4623093024109],[-58.8038774463801,-27.4621326938943],[-58.8039109281648,-27.4620149767085],[-58.8038888689772,-27.461902489998],[-58.8038661489777,-27.4617494137389],[-58.8038139751604,-27.4616508498556],[-58.8038076710735,-27.4615742462166],[-58.8039416084972,-27.4614146294794],[-58.8039927542319,-27.4614500540333],[-58.8040183271113,-27.4614677663026],[-58.8040540850945,-27.4614898575017],[-58.8040896962166,-27.4615029287936],[-58.8041256011028,-27.46153403987],[-58.8041766000672,-27.4615604444535],[-58.8042372700606,-27.4615596583001],[-58.8042778636122,-27.4615681540794],[-58.8043388273979,-27.4615854076735],[-58.8044048470353,-27.46160259572],[-58.8044706463314,-27.4616062538914],[-58.8045412810955,-27.461596316664],[-58.8045867835964,-27.4615957269316],[-58.8046320657163,-27.4615816073426],[-58.8046721450692,-27.4615585333748],[-58.80471259172,-27.4615580091316],[-58.8047580942008,-27.4615574193439],[-58.8047983939162,-27.461547875182],[-58.8048532733648,-27.4615020548272],[-58.8049189991317,-27.4615012028421],[-58.8049695574119,-27.4615005474479],[-58.8050199687398,-27.4614908721426],[-58.8050647364144,-27.4614451827935],[-58.8051044482294,-27.4613995589766],[-58.8051343422888,-27.4613721060265],[-58.8051793303129,-27.4613399464825],[-58.8052299619957,-27.4613438009432],[-58.8052707759811,-27.4613658262708],[-58.8053417779369,-27.461378438376],[-58.8053973184802,-27.46137320733],[-58.805467805999,-27.4613542497526],[-58.8054985818843,-27.461380916072],[-58.8055393224364,-27.4613984313723],[-58.805579548516,-27.4613843770451],[-58.8056247569054,-27.461365747198],[-58.8056853532417,-27.4613604504741],[-58.8057416287947,-27.4614003187384],[-58.8057020642589,-27.4614549626138],[-58.8056472587048,-27.4615052932304],[-58.8056024177599,-27.4615464728113],[-58.8055625591142,-27.4615830768722],[-58.8055224799538,-27.4616061510878],[-58.8054772714494,-27.4616247809066],[-58.8054576360694,-27.4616611227025],[-58.8054783738667,-27.4616924300829],[-58.8055232884123,-27.4616557604827],[-58.8055635145857,-27.4616417061559],[-58.8056035202499,-27.4616141219837],[-58.8056433053909,-27.4615730079666],[-58.8057033873151,-27.4615361416172],[-58.8057583398676,-27.4614948308682],[-58.8057728457906,-27.4614540446602],[-58.8058124102899,-27.4613994007664],[-58.8058168045441,-27.4613587456958],[-58.805785734569,-27.4613140396719],[-58.8057696850549,-27.4612601170446],[-58.8057438179488,-27.461224365329],[-58.8057027099228,-27.4611843003624],[-58.8056718605477,-27.4611531241423],[-58.8057017543963,-27.4611256710794],[-58.8057417598449,-27.461098086876],[-58.8057818387784,-27.4610750126067],[-58.8058274145409,-27.4610789324239],[-58.805898416357,-27.4610915442514],[-58.8059542507658,-27.4611043527684],[-58.8060048823503,-27.4611082069512],[-58.8060709754264,-27.4611299041537],[-58.806116624735,-27.4611383338184],[-58.8061776620391,-27.4611600965494],[-58.806228955364,-27.461204540141],[-58.806260319579,-27.461267285833],[-58.8062916103046,-27.4613255215725],[-58.80636246526,-27.4613291132664],[-58.806388626708,-27.4613829046276],[-58.806389214954,-27.4614189841715],[-58.8064750903615,-27.4614133591434],[-58.8063497624948,-27.4608601447568],[-58.8061845215873,-27.4606502761485],[-58.8060437515513,-27.4603904700356],[-58.8060484397571,-27.4603678547361],[-58.8061135598581,-27.4600196709178],[-58.8064349047938,-27.4595689234741]]]}"
55,392,424,816,323,301,6.63,123,"{""type"":""Polygon"",""coordinates"":[[[-58.8216941290139,-27.4615894763393],[-58.8205418542115,-27.4616316126752],[-58.819222958854,-27.4616894492625],[-58.8192455118169,-27.4624469820935],[-58.8192780290138,-27.4631953628819],[-58.8193380290484,-27.4643854503614],[-58.8206472891999,-27.4643548028113],[-58.8206224119282,-27.4637642035204],[-58.8218151558576,-27.463721536204],[-58.821760011749,-27.4631358441941],[-58.8217169954249,-27.4623650475752],[-58.8216941290139,-27.4615894763393]]]}"
56,436,506,942,314,357,7.78,121,"{""type"":""Polygon"",""coordinates"":[[[-58.8218151558576,-27.463721536204],[-58.8206224119282,-27.4637642035204],[-58.8206472891999,-27.4643548028113],[-58.8193380290484,-27.4643854503614],[-58.8193674730952,-27.465562404271],[-58.8193691387523,-27.4662796117225],[-58.8194130496203,-27.4667977885174],[-58.8198831120609,-27.4667826228145],[-58.8207117072314,-27.4667357018079],[-58.8210557391642,-27.4667447347054],[-58.821650717942,-27.4666377115687],[-58.8218976467203,-27.4665848607366],[-58.8219676149014,-27.4665343254868],[-58.8220326753772,-27.4664928761764],[-58.8221584078713,-27.4664506327482],[-58.822269194832,-27.466422117449],[-58.8223754451081,-27.4664252375453],[-58.8224566379684,-27.4664422181909],[-58.8221291217498,-27.4662074290016],[-58.8220615623782,-27.4654820628633],[-58.8219657455182,-27.4648833708168],[-58.8219211565104,-27.4643246061163],[-58.8218151558576,-27.463721536204]]]}"
57,312,375,687,230,236,7.28,94,"{""type"":""Polygon"",""coordinates"":[[[-58.8193380290484,-27.4643854503614],[-58.8180037098375,-27.4644299454666],[-58.8166948163487,-27.4644831177998],[-58.8167592544847,-27.4656370622058],[-58.8167965173027,-27.4663673383843],[-58.8168257400649,-27.4672240239912],[-58.8174816211736,-27.4671297562894],[-58.8181261304519,-27.4669589491398],[-58.8183469674352,-27.4668568256349],[-58.8194130496203,-27.4667977885174],[-58.8193691387523,-27.4662796117225],[-58.8193674730952,-27.465562404271],[-58.8193380290484,-27.4643854503614]]]}"
72,463,495,958,240,246,9.53,101,"{""type"":""Polygon"",""coordinates"":[[[-58.7902326587165,-27.4604954128339],[-58.789687795301,-27.4605745918713],[-58.7896124677951,-27.4606071365008],[-58.7891484966034,-27.4606852737516],[-58.7890419599572,-27.4606640880285],[-58.7883961961905,-27.4607580912255],[-58.7877609067002,-27.4608745115969],[-58.7872344804023,-27.4611564360239],[-58.7870389021299,-27.4612581866253],[-58.7866427613246,-27.4614662619178],[-58.7873125035464,-27.4625447990857],[-58.7879818225194,-27.4635962723257],[-58.7885938451653,-27.4632906906523],[-58.7891352996686,-27.4629995459712],[-58.7900434011555,-27.4628660790832],[-58.7906788447111,-27.4627586678554],[-58.7909965659636,-27.462704961175],[-58.7907963280384,-27.4615798070478],[-58.790582093546,-27.4605270070379],[-58.7902326587165,-27.4604954128339]]]}"
281,590,638,1228,334,346,10.99,112,"{""type"":""Polygon"",""coordinates"":[[[-58.8425348219342,-27.4811268501563],[-58.8412329144128,-27.4813064709135],[-58.8405362241185,-27.4813833491565],[-58.8398399074239,-27.481482773186],[-58.8399810571238,-27.4826717678224],[-58.8401569330941,-27.4838197053141],[-58.8403247994747,-27.4850940515614],[-58.840713573397,-27.4850528228037],[-58.8410366085723,-27.485012462716],[-58.8414052296667,-27.4849760094979],[-58.8417787571606,-27.4849304687085],[-58.8424199187941,-27.4848588295443],[-58.8430510409482,-27.4847918312501],[-58.8428627669662,-27.4835087379486],[-58.8427120721179,-27.4823559605635],[-58.8425348219342,-27.4811268501563]]]}"
45,647,668,1315,300,301,44.22,30,"{""type"":""Polygon"",""coordinates"":[[[-58.8009359225611,-27.4569426323896],[-58.8002554641156,-27.4564552310933],[-58.7996068120814,-27.45574638061],[-58.7990420589355,-27.4552213902628],[-58.7985292571229,-27.4547814337922],[-58.7979449433236,-27.4546085424142],[-58.7974527363893,-27.4541908703644],[-58.7972875955518,-27.4539854996838],[-58.7956211364225,-27.4550580401256],[-58.7949946273893,-27.4547774183027],[-58.7945878464569,-27.454638311552],[-58.7942642916153,-27.4546424806829],[-58.7941137934244,-27.4547165943498],[-58.7940764527337,-27.4555335516104],[-58.7938601391928,-27.4559152553719],[-58.7937872981753,-27.4561011413139],[-58.7937310107916,-27.4563725214393],[-58.7937472726791,-27.4564399757391],[-58.793712540276,-27.4564810213874],[-58.7936729712097,-27.4565356620806],[-58.7937187639056,-27.4565531159084],[-58.7937745218788,-27.4565614195194],[-58.7938659613215,-27.4565873071352],[-58.7939316845718,-27.4565864604741],[-58.7939373242793,-27.4566224751612],[-58.7939480926387,-27.4566629346951],[-58.7939790105547,-27.4566986237284],[-58.7939949806034,-27.4567480380796],[-58.7940058950236,-27.4567975175602],[-58.7940321954346,-27.4568603315702],[-58.7940580577872,-27.4568960857143],[-58.7940993061567,-27.4569451743751],[-58.7941202589352,-27.4569900135937],[-58.7941310274044,-27.4570304731064],[-58.7941724218989,-27.4570885816931],[-58.7942338930292,-27.4571374097499],[-58.7942793209331,-27.4571323134964],[-58.7943092167283,-27.4571048627818],[-58.7943641717034,-27.4570635564081],[-58.7944303334019,-27.4570897693514],[-58.7945169368616,-27.4571292515835],[-58.7945380359154,-27.4571831106786],[-58.794559281064,-27.4572459897193],[-58.794570049722,-27.4572864491878],[-58.7945555400561,-27.4573272344232],[-58.7945570007904,-27.457417433923],[-58.7945727521029,-27.4574533182611],[-58.7946143661112,-27.4575249566186],[-58.7945997103578,-27.4575567219086],[-58.7945852006736,-27.4575975071468],[-58.7945909867413,-27.4576425417393],[-58.7946365609091,-27.4576464653097],[-58.7946408131396,-27.457596790432],[-58.7946553228029,-27.4575560051889],[-58.7946749611732,-27.4575196647613],[-58.7946795785952,-27.4574925397557],[-58.7947094013346,-27.4574605789821],[-58.7947604693734,-27.4574914972028],[-58.7948156434952,-27.4574637205748],[-58.7948811480802,-27.4574493435185],[-58.7949213012425,-27.4574307822939],[-58.7949669483815,-27.4574392157339],[-58.7950028494608,-27.4574703293674],[-58.795039188901,-27.4575285028328],[-58.7950039452905,-27.4575379789744],[-58.7949533885403,-27.4575386306648],[-58.7949641573753,-27.4575790900929],[-58.794954703504,-27.4576198101945],[-58.794945614894,-27.4576830801647],[-58.7950114118111,-27.4576867429368],[-58.7950569129458,-27.4576861563944],[-58.7950827758265,-27.4577219103189],[-58.7950786699121,-27.4577806051469],[-58.7951044597631,-27.4578118490921],[-58.7951454166945,-27.4578428975053],[-58.7952065233427,-27.4578691752214],[-58.7952472611236,-27.4578866936831],[-58.7952877797125,-27.4578906822137],[-58.795353284472,-27.4578763049268],[-58.7954034760015,-27.457853103221],[-58.7954792382469,-27.4578476154508],[-58.7955102300666,-27.457887814071],[-58.7955259817575,-27.4579236982808],[-58.7955673042412,-27.4579772964223],[-58.7956335398314,-27.4580080187226],[-58.7956742777247,-27.4580255370533],[-58.795730401978,-27.4580563896949],[-58.795812170201,-27.4581094661692],[-58.7958630195566,-27.4581268540397],[-58.7959241996116,-27.4581576413952],[-58.7959700664003,-27.4581796044003],[-58.7960361560159,-27.4582013065553],[-58.7960819497418,-27.4582187595507],[-58.796178081201,-27.4582220304872],[-58.7962481299583,-27.4581760177697],[-58.7963040351051,-27.4581933402576],[-58.7963604520575,-27.4582422325119],[-58.796381040439,-27.4582645214771],[-58.7964472032917,-27.4582907334001],[-58.7965132199355,-27.458307925351],[-58.7965639963573,-27.4583208029859],[-58.7966047344994,-27.4583383210309],[-58.7966810088596,-27.4583644023778],[-58.7967366216464,-27.4583636848078],[-58.7967575026421,-27.4584040135877],[-58.7967987527615,-27.4584531013541],[-58.7968697521263,-27.4584657179225],[-58.7969357689296,-27.4584829096644],[-58.7969813434818,-27.4584868324461],[-58.7970223011669,-27.4585178802669],[-58.7970531474441,-27.4585490585678],[-58.7970689728741,-27.4585894525393],[-58.7971204809286,-27.4586474296399],[-58.7971915535939,-27.4586645560037],[-58.797237274525,-27.4586774986324],[-58.7972778665931,-27.4586859965334],[-58.7973234412347,-27.4586899191983],[-58.7973742179107,-27.458702796524],[-58.7974149563107,-27.4587203143181],[-58.7974508584766,-27.4587514272618],[-58.7974866875022,-27.4587780302283],[-58.7975374642346,-27.4587909074915],[-58.7976185753304,-27.4588033931332],[-58.7977050348448,-27.4588338533209],[-58.7977566896828,-27.4589008500949],[-58.7977876094432,-27.4589365381824],[-58.7978181633518,-27.4589496764325],[-58.7978539925269,-27.4589762792965],[-58.7978897485417,-27.4589983721847],[-58.7978952433412,-27.4590253667006],[-58.7978912120933,-27.4590885714975],[-58.7978808014299,-27.4593819150919],[-58.7978898756626,-27.4599411507837],[-58.7978997551655,-27.4605499960392],[-58.7964966744067,-27.4600944601191],[-58.7965321179064,-27.4607210195401],[-58.7965687321173,-27.4614197383578],[-58.7966908769547,-27.4614677822974],[-58.7971641434287,-27.4616511327715],[-58.7971170231236,-27.4618637537288],[-58.7971571693857,-27.4621564446923],[-58.7972669201568,-27.4626873153637],[-58.7978545026661,-27.4627473930341],[-58.7977824636236,-27.4632941431324],[-58.7976328825248,-27.4646719014101],[-58.7984536371955,-27.4647650525837],[-58.7993145479206,-27.4648396362823],[-58.7994642545978,-27.4634708971403],[-58.8003248623489,-27.4635274352241],[-58.8003945435106,-27.4628363658016],[-58.800464370645,-27.4621543162352],[-58.8005374220677,-27.4616707047391],[-58.8006110608974,-27.4615344253041],[-58.8005995566,-27.4614488668789],[-58.8005625532739,-27.461350105481],[-58.8006290822436,-27.460776360154],[-58.8005833587514,-27.4604521662265],[-58.800585700261,-27.4596627273902],[-58.8006935554041,-27.4594538309637],[-58.8008113017413,-27.4592312738238],[-58.8008069772475,-27.4589651862804],[-58.800752975211,-27.4587538720516],[-58.8006788971628,-27.4585518392179],[-58.8007019036914,-27.4584117035951],[-58.8007692387287,-27.4581988202041],[-58.8009427427882,-27.4579845637112],[-58.8010611469522,-27.4578025960424],[-58.8011647502862,-27.4576433742612],[-58.8011267949833,-27.4574859834636],[-58.8010375503134,-27.4572841469519],[-58.8009359225611,-27.4569426323896]]]}"
46,564,568,1132,291,277,19.77,57,"{""type"":""Polygon"",""coordinates"":[[[-58.7944303334019,-27.4570897693514],[-58.7944361923991,-27.4571393139332],[-58.7944488598291,-27.4572970327734],[-58.7944847444048,-27.457639399983],[-58.7944850365435,-27.457657439883],[-58.7945391561108,-27.4581890305262],[-58.7945935685197,-27.4587386609811],[-58.794636336158,-27.4591937122236],[-58.79469514817,-27.4597026875966],[-58.7947541069691,-27.4602206828289],[-58.7947873490173,-27.4607119439873],[-58.7949278313817,-27.4618919924245],[-58.7949777042259,-27.4624732572441],[-58.7950381280735,-27.4630814514293],[-58.7950998681993,-27.4637708249574],[-58.7951668845919,-27.4644736630722],[-58.7952542723718,-27.4651852602017],[-58.7953313301521,-27.4658834576511],[-58.7960352915726,-27.4659465525275],[-58.7960239576198,-27.4652475077951],[-58.7960164262515,-27.4647829812542],[-58.7969481935911,-27.4648611764936],[-58.7976012961227,-27.4649068764298],[-58.7976328825248,-27.4646719014101],[-58.7977824636236,-27.4632941431324],[-58.7978545026661,-27.4627473930341],[-58.7972669201568,-27.4626873153637],[-58.7971571693857,-27.4621564446923],[-58.7971170231236,-27.4618637537288],[-58.7971641434287,-27.4616511327715],[-58.7966908769547,-27.4614677822974],[-58.7965687321173,-27.4614197383578],[-58.7965321179064,-27.4607210195401],[-58.7964966744067,-27.4600944601191],[-58.7978997551655,-27.4605499960392],[-58.7978898756626,-27.4599411507837],[-58.7978808014299,-27.4593819150919],[-58.7978912120933,-27.4590885714975],[-58.7978952433412,-27.4590253667006],[-58.7978897485417,-27.4589983721847],[-58.7978539925269,-27.4589762792965],[-58.7978181633518,-27.4589496764325],[-58.7977876094432,-27.4589365381824],[-58.7977566896828,-27.4589008500949],[-58.7977050348448,-27.4588338533209],[-58.7976185753304,-27.4588033931332],[-58.7975374642346,-27.4587909074915],[-58.7974866875022,-27.4587780302283],[-58.7974508584766,-27.4587514272618],[-58.7974149563107,-27.4587203143181],[-58.7973742179107,-27.458702796524],[-58.7973234412347,-27.4586899191983],[-58.7972778665931,-27.4586859965334],[-58.797237274525,-27.4586774986324],[-58.7971915535939,-27.4586645560037],[-58.7971204809286,-27.4586474296399],[-58.7970689728741,-27.4585894525393],[-58.7970531474441,-27.4585490585678],[-58.7970223011669,-27.4585178802669],[-58.7969813434818,-27.4584868324461],[-58.7969357689296,-27.4584829096644],[-58.7968697521263,-27.4584657179225],[-58.7967987527615,-27.4584531013541],[-58.7967575026421,-27.4584040135877],[-58.7967366216464,-27.4583636848078],[-58.7966810088596,-27.4583644023778],[-58.7966047344994,-27.4583383210309],[-58.7965639963573,-27.4583208029859],[-58.7965132199355,-27.458307925351],[-58.7964472032917,-27.4582907334001],[-58.796381040439,-27.4582645214771],[-58.7963604520575,-27.4582422325119],[-58.7963040351051,-27.4581933402576],[-58.7962481299583,-27.4581760177697],[-58.796178081201,-27.4582220304872],[-58.7960819497418,-27.4582187595507],[-58.7960361560159,-27.4582013065553],[-58.7959700664003,-27.4581796044003],[-58.7959241996116,-27.4581576413952],[-58.7958630195566,-27.4581268540397],[-58.795812170201,-27.4581094661692],[-58.795730401978,-27.4580563896949],[-58.7956742777247,-27.4580255370533],[-58.7956335398314,-27.4580080187226],[-58.7955673042412,-27.4579772964223],[-58.7955259817575,-27.4579236982808],[-58.7955102300666,-27.457887814071],[-58.7954792382469,-27.4578476154508],[-58.7954034760015,-27.457853103221],[-58.795353284472,-27.4578763049268],[-58.7952877797125,-27.4578906822137],[-58.7952472611236,-27.4578866936831],[-58.7952065233427,-27.4578691752214],[-58.7951454166945,-27.4578428975053],[-58.7951044597631,-27.4578118490921],[-58.7950786699121,-27.4577806051469],[-58.7950827758265,-27.4577219103189],[-58.7950569129458,-27.4576861563944],[-58.7950114118111,-27.4576867429368],[-58.794945614894,-27.4576830801647],[-58.794954703504,-27.4576198101945],[-58.7949641573753,-27.4575790900929],[-58.7949533885403,-27.4575386306648],[-58.7950039452905,-27.4575379789744],[-58.795039188901,-27.4575285028328],[-58.7950028494608,-27.4574703293674],[-58.7949669483815,-27.4574392157339],[-58.7949213012425,-27.4574307822939],[-58.7948811480802,-27.4574493435185],[-58.7948156434952,-27.4574637205748],[-58.7947604693734,-27.4574914972028],[-58.7947094013346,-27.4574605789821],[-58.7946795785952,-27.4574925397557],[-58.7946749611732,-27.4575196647613],[-58.7946553228029,-27.4575560051889],[-58.7946408131396,-27.457596790432],[-58.7946365609091,-27.4576464653097],[-58.7945909867413,-27.4576425417393],[-58.7945852006736,-27.4575975071468],[-58.7945997103578,-27.4575567219086],[-58.7946143661112,-27.4575249566186],[-58.7945727521029,-27.4574533182611],[-58.7945570007904,-27.457417433923],[-58.7945555400561,-27.4573272344232],[-58.794570049722,-27.4572864491878],[-58.794559281064,-27.4572459897193],[-58.7945380359154,-27.4571831106786],[-58.7945169368616,-27.4571292515835],[-58.7944303334019,-27.4570897693514]]]}"
47,411,443,854,252,233,10.32,83,"{""type"":""Polygon"",""coordinates"":[[[-58.7984536371955,-27.4647650525837],[-58.7976328825248,-27.4646719014101],[-58.7976012961227,-27.4649068764298],[-58.7969481935911,-27.4648611764936],[-58.7960164262515,-27.4647829812542],[-58.7960239576198,-27.4652475077951],[-58.7960352915726,-27.4659465525275],[-58.7953313301521,-27.4658834576511],[-58.7953984231934,-27.4665908052869],[-58.7954602419302,-27.4672846880898],[-58.7955489508765,-27.4680774639465],[-58.7957267936779,-27.4681293009708],[-58.7960618163133,-27.4682061754554],[-58.7963410753069,-27.4682747468555],[-58.7965643510538,-27.4683214856264],[-58.7969351337339,-27.4684204510048],[-58.7971940958588,-27.4684847717321],[-58.7975599697723,-27.4685928205844],[-58.7980169287283,-27.4687042029616],[-58.7981494312028,-27.4675206344823],[-58.7983141025085,-27.4661381704232],[-58.7984536371955,-27.4647650525837]]]}"
48,522,595,1117,293,211,8.97,125,"{""type"":""Polygon"",""coordinates"":[[[-58.8003248623489,-27.4635274352241],[-58.7994642545978,-27.4634708971403],[-58.7993145479206,-27.4648396362823],[-58.7984536371955,-27.4647650525837],[-58.7983141025085,-27.4661381704232],[-58.7981494312028,-27.4675206344823],[-58.7980169287283,-27.4687042029616],[-58.7981896441216,-27.4687515920751],[-58.7987943321833,-27.4689287271182],[-58.7993982893357,-27.4690607598824],[-58.7996974838122,-27.4691110230963],[-58.7998509253254,-27.4676610397293],[-58.7999347527812,-27.4669066351826],[-58.80000560982,-27.4662877253466],[-58.8000497211157,-27.4658901955285],[-58.8001451967919,-27.464919116794],[-58.8003248623489,-27.4635274352241]]]}"
49,399,376,775,208,177,10.1,77,"{""type"":""Polygon"",""coordinates"":[[[-58.8017554237474,-27.465047147428],[-58.8009097519806,-27.4649768927418],[-58.8001451967919,-27.464919116794],[-58.8000497211157,-27.4658901955285],[-58.80000560982,-27.4662877253466],[-58.7999347527812,-27.4669066351826],[-58.7998509253254,-27.4676610397293],[-58.7996974838122,-27.4691110230963],[-58.8000474603263,-27.4691741617397],[-58.8003210811233,-27.4692067106608],[-58.8013488032054,-27.4689633601222],[-58.8017565194685,-27.4688453113354],[-58.8025619836695,-27.4686183611306],[-58.8028487899548,-27.4685289401308],[-58.8025895883399,-27.4678285964747],[-58.8023518621471,-27.4672046594203],[-58.8021292336512,-27.4665760154832],[-58.8018860902733,-27.4659295929635],[-58.8016445006793,-27.4660003830586],[-58.8017263401049,-27.4654354613251],[-58.8017554237474,-27.465047147428]]]}"
50,693,706,1399,337,313,9.12,153,"{""type"":""Polygon"",""coordinates"":[[[-58.8038603955337,-27.4648123890146],[-58.8035007599447,-27.464776450041],[-58.8032729471022,-27.4647613572999],[-58.8026498870312,-27.4646972514752],[-58.8023663852235,-27.4646783673687],[-58.8018043644197,-27.4646360220245],[-58.8017554237474,-27.465047147428],[-58.8017263401049,-27.4654354613251],[-58.8016445006793,-27.4660003830586],[-58.8018860902733,-27.4659295929635],[-58.8021292336512,-27.4665760154832],[-58.8023518621471,-27.4672046594203],[-58.8025895883399,-27.4678285964747],[-58.8028487899548,-27.4685289401308],[-58.8037698795203,-27.4682598875859],[-58.8041372146216,-27.4681468660902],[-58.8042630302315,-27.4681091483644],[-58.8050429820684,-27.4678689820941],[-58.8060797621029,-27.46756232739],[-58.8059382472275,-27.4672574224251],[-58.8058124160698,-27.466983890104],[-58.8054804793063,-27.4670964567779],[-58.8054302860352,-27.4671196621886],[-58.8047700700183,-27.4672590385584],[-58.804622988696,-27.4669226279897],[-58.8044698971639,-27.466527653463],[-58.8043489925333,-27.4665562858758],[-58.8038109316683,-27.4667436942572],[-58.8038598535258,-27.46602131676],[-58.8037842220378,-27.4657245774078],[-58.8038417363875,-27.4655298636126],[-58.8039053232729,-27.4650869717096],[-58.8038603955337,-27.4648123890146]]]}"
51,640,719,1359,365,371,9.41,144,"{""type"":""Polygon"",""coordinates"":[[[-58.8059327810714,-27.46382019121],[-58.8054505721269,-27.4640204136611],[-58.8049632319256,-27.4642161901213],[-58.8044561068393,-27.4644392867415],[-58.804665031189,-27.4648470704813],[-58.8041491006394,-27.4648402244232],[-58.8038603955337,-27.4648123890146],[-58.8039053232729,-27.4650869717096],[-58.8038417363875,-27.4655298636126],[-58.8037842220378,-27.4657245774078],[-58.8038598535258,-27.46602131676],[-58.8038109316683,-27.4667436942572],[-58.8043489925333,-27.4665562858758],[-58.8044698971639,-27.466527653463],[-58.804622988696,-27.4669226279897],[-58.8047700700183,-27.4672590385584],[-58.8054302860352,-27.4671196621886],[-58.8054804793063,-27.4670964567779],[-58.8058124160698,-27.466983890104],[-58.8059382472275,-27.4672574224251],[-58.8060797621029,-27.46756232739],[-58.8062207445903,-27.4675244111726],[-58.8065928362646,-27.4673932780674],[-58.8071117742069,-27.4672737706056],[-58.8076306373201,-27.4671497513244],[-58.8072491080608,-27.4663923638259],[-58.8070348208563,-27.4659666105228],[-58.8068206089404,-27.4655453667246],[-58.8063715986476,-27.4646805905208],[-58.8059327810714,-27.46382019121]]]}"
75,338,382,720,225,279,10.93,66,"{""type"":""Polygon"",""coordinates"":[[[-58.7790221325888,-27.4608465994085],[-58.7784953084985,-27.460790176337],[-58.7775534694805,-27.4607119843423],[-58.7772496109738,-27.4606842865106],[-58.7762117117703,-27.4606073114294],[-58.7753761927178,-27.4605367701657],[-58.7751116320058,-27.4613836892584],[-58.7746699672191,-27.4628553752572],[-58.7755632878115,-27.4630605112507],[-58.7764316930444,-27.4632885139701],[-58.7773760138618,-27.463520052982],[-58.7783156442486,-27.4637742000238],[-58.7785302766688,-27.462968511953],[-58.7785239898735,-27.4628919063511],[-58.7786799032495,-27.4622087633732],[-58.7788603703418,-27.4614801971771],[-58.7790221325888,-27.4608465994085]]]}"
58,898,906,1804,444,490,95.73,19,"{""type"":""Polygon"",""coordinates"":[[[-58.7812315194223,-27.4353270278942],[-58.7806683750183,-27.4358349416093],[-58.7806921418333,-27.4360556743271],[-58.7807096954937,-27.4362043112699],[-58.7808901598173,-27.4364230410767],[-58.780859903723,-27.436427938768],[-58.7808245928735,-27.4364329010626],[-58.7807944815972,-27.4364468187848],[-58.7807593155594,-27.4364608011083],[-58.7807240771029,-27.4364702734008],[-58.7806938209864,-27.4364751710569],[-58.780623199234,-27.4364850955551],[-58.7805930155118,-27.4364945032126],[-58.7805577770281,-27.4365039754641],[-58.7804971923544,-27.436509260676],[-58.780452206335,-27.4365414122133],[-58.7804221673758,-27.4365598398818],[-58.7803921284064,-27.4365782675442],[-58.780362234217,-27.4366057152475],[-58.7803373947754,-27.4366330983526],[-58.780322737243,-27.4366648622937],[-58.7803080073096,-27.43669211621],[-58.7802779682852,-27.4367105438501],[-58.7802428744834,-27.4367290360734],[-58.7802178902059,-27.4367473991121],[-58.7801929059199,-27.4367657621466],[-58.7801732659475,-27.4368021006855],[-58.7801637355076,-27.4368383100492],[-58.7801439507399,-27.436865628537],[-58.7801189664154,-27.4368839915598],[-58.7800939820826,-27.4369023545786],[-58.780063942965,-27.4369207821764],[-58.7800390309976,-27.4369436552099],[-58.780014191402,-27.4369710382635],[-58.7799893517942,-27.4369984213132],[-58.7799746217373,-27.437025675199],[-58.7799649464561,-27.4370528645038],[-58.7799452339821,-27.4370846929909],[-58.7799151947903,-27.4371031205596],[-58.7798902103744,-27.4371214835452],[-58.7798805350652,-27.4371486728451],[-58.7798860964947,-27.4371801784378],[-58.77990169513,-27.4372070448504],[-58.7799071841909,-27.4372340404174],[-58.7799025636701,-27.4372611651404],[-58.7798980155259,-27.4372927998874],[-58.7798933950012,-27.4373199246101],[-58.7798988840674,-27.4373469201768],[-58.7798993907177,-27.4373784903455],[-58.7799200441858,-27.4374052921755],[-58.7799406252835,-27.4374275839779],[-58.7799411319475,-27.4374591541454],[-58.7799161474594,-27.4374775171384],[-58.7798911629629,-27.4374958801272],[-58.7798662508358,-27.4375187531359],[-58.7798565754918,-27.4375459424346],[-58.7798671193702,-27.4375728734245],[-58.7798927552985,-27.437595100655],[-58.7799183912371,-27.4376173278802],[-58.7799490819954,-27.4376394905196],[-58.7799545710955,-27.4376664860816],[-58.7799752246342,-27.4376932878992],[-58.779980713744,-27.4377202834595],[-58.7799912576711,-27.4377472144371],[-58.7800018016037,-27.4377741454137],[-58.7800124179263,-27.4378055864126],[-58.7800080145696,-27.4378462412074],[-58.7799781923405,-27.4378781988679],[-58.7799429533621,-27.4378876709854],[-58.7799173173531,-27.4378654437688],[-58.779887133193,-27.4378748512924],[-58.7798673481851,-27.4379021697491],[-58.779852690369,-27.4379339336496],[-58.779837960167,-27.437961187525],[-58.7798181027552,-27.4379839959518],[-58.7797983900882,-27.4380158244239],[-58.779773405455,-27.4380341873969],[-58.779748493188,-27.4380570603899],[-58.7797287804888,-27.4380888888534],[-58.7797191050691,-27.4381160781444],[-58.779709429645,-27.4381432674348],[-58.7796948441278,-27.4381795413454],[-58.779680113857,-27.4382067952066],[-58.7796602563703,-27.4382296036138],[-58.7796251619905,-27.4382480957054],[-58.7795950500686,-27.4382620131955],[-58.7795596661965,-27.4382624651743],[-58.7795243546897,-27.4382674271686],[-58.7794939532889,-27.4382633045397],[-58.7794637689811,-27.4382727119778],[-58.7794337293929,-27.4382911394589],[-58.7794039068788,-27.4383230970079],[-58.7793734331053,-27.4383144643285],[-58.7793377597774,-27.4382968761524],[-58.7792625883598,-27.4383384347539],[-58.779237820627,-27.4383703277128],[-58.7792232349271,-27.4384066015817],[-58.7791932676141,-27.4384295390393],[-58.7791835920361,-27.4384567282995],[-58.7791942082074,-27.4384881693658],[-58.779214861734,-27.4385149712946],[-58.7792254055656,-27.4385419023326],[-58.7792209295509,-27.4385780470886],[-58.7792012889661,-27.4386143855118],[-58.7791765935113,-27.4386507884875],[-58.7791720451252,-27.4386824232173],[-58.7791926263316,-27.4387047151223],[-58.7792233172684,-27.438726877911],[-58.7792588460088,-27.4387354460601],[-58.7792893922506,-27.4387485887837],[-58.7793150283554,-27.4387708161095],[-58.779305352783,-27.4387980053769],[-58.7792803678942,-27.4388163682718],[-58.7792554553542,-27.4388392411872],[-58.7792561065679,-27.4388798314095],[-58.779241520817,-27.4389161052807],[-58.7792318452157,-27.4389432945439],[-58.7792119875101,-27.4389661028955],[-58.7792075838376,-27.4390067576747],[-58.7792231825965,-27.4390336241522],[-58.7792488187581,-27.4390558514869],[-58.7792895472014,-27.4390733751134],[-58.7793052183498,-27.4391047516045],[-58.7793057248691,-27.4391363217753],[-58.7792960492678,-27.4391635110424],[-58.7792914285441,-27.4391906357489],[-58.7792767704111,-27.4392223995991],[-58.7792466581837,-27.4392363170267],[-58.7792216731901,-27.4392546799151],[-58.7792069426729,-27.4392819337346],[-58.779202321924,-27.439309058439],[-58.7791875913955,-27.4393363122568],[-58.7791830429961,-27.4393679469852],[-58.7791784945946,-27.4393995817135],[-58.7791688912977,-27.4394312809978],[-58.7791642705354,-27.4394584057011],[-58.7791597221263,-27.4394900404288],[-58.77916528351,-27.4395215460444],[-58.7791608074551,-27.4395576907964],[-58.7791460768867,-27.4395849446109],[-58.7791313463114,-27.4396121984242],[-58.779116688083,-27.4396439622606],[-58.779086575722,-27.4396578796591],[-58.7790615906094,-27.4396762425236],[-58.779046860002,-27.4397034963291],[-58.779022019573,-27.4397308792364],[-58.7790072889492,-27.4397581330383],[-58.7789976855777,-27.4397898323131],[-58.7789779000294,-27.439817150663],[-58.7789581868196,-27.4398489790352],[-58.7789485110799,-27.4398761682824],[-58.7789287255049,-27.4399034866263],[-58.7789241770175,-27.4399351213485],[-58.7789448307717,-27.4399619233023],[-58.7789604296169,-27.4399887898023],[-58.7789709735494,-27.4400157208505],[-58.7789815174875,-27.4400426518974],[-58.7790020989261,-27.4400649438162],[-58.7789974781056,-27.4400920685148],[-58.7789928572831,-27.4401191932133],[-58.7789832538823,-27.4401508924872],[-58.7789838326828,-27.4401869726834],[-58.7789994315721,-27.4402138391763],[-58.7790099755386,-27.4402407702192],[-58.7790306293742,-27.4402675721554],[-58.7790121460867,-27.4403760709502],[-58.7790327999499,-27.4404028728844],[-58.7790538879459,-27.4404567349601],[-58.7790442121859,-27.4404839242131],[-58.7790396637177,-27.4405155589361],[-58.779040170192,-27.4405471291052],[-58.7790457316129,-27.44057863472],[-58.7790463827982,-27.4406192249369],[-58.7790418343274,-27.4406508596596],[-58.7790372135008,-27.4406779843581],[-58.7790377923318,-27.4407140645505],[-58.7790483363623,-27.4407409955859],[-58.7790489151985,-27.4407770757777],[-58.7790544042825,-27.4408040713667],[-58.7790497834547,-27.4408311960652],[-58.779040180021,-27.4408628953421],[-58.7789040673699,-27.4412029546097],[-58.7789071060852,-27.4413923756171],[-58.7789295689244,-27.4415319281507],[-58.7789216295022,-27.4416673579669],[-58.7789034353627,-27.4417938968373],[-58.7788669746335,-27.4420424645467],[-58.7788295008698,-27.4422278919162],[-58.7788200419748,-27.4422686112277],[-58.7786665193684,-27.4424690532276],[-58.778537475696,-27.4426195621161],[-58.7784586204691,-27.4427468754114],[-58.7783653955764,-27.4429239925394],[-58.7781195782915,-27.4430444151557],[-58.7779355712388,-27.4429204572599],[-58.7769850036441,-27.442919053493],[-58.7769671006175,-27.4433793987232],[-58.7769398145521,-27.444200739548],[-58.7766292193058,-27.4446963947755],[-58.7757270972924,-27.4458266135037],[-58.776063268785,-27.4459802107102],[-58.7768706595304,-27.4461954609321],[-58.7774030469617,-27.4462879092895],[-58.7781312946714,-27.4466124246048],[-58.7783499538026,-27.4460592976965],[-58.779401808263,-27.446384185311],[-58.7804432683119,-27.4466911538406],[-58.7814847337156,-27.4469981142922],[-58.7825623163504,-27.4473497139076],[-58.7826252062481,-27.4471729824114],[-58.7827078092159,-27.4469644220133],[-58.7831498626464,-27.4470986026567],[-58.7832159433756,-27.447120311367],[-58.783297262376,-27.447146335887],[-58.7833891997371,-27.4472038009703],[-58.7834256021225,-27.4472664880102],[-58.7834574571882,-27.447360809829],[-58.7834737837957,-27.4474327757826],[-58.7839206774404,-27.4475533590833],[-58.7843882285562,-27.4477007418878],[-58.7845142203659,-27.4473608075172],[-58.7847365966252,-27.4467264272044],[-58.7849733201299,-27.446669262563],[-58.7852113505872,-27.4466932776205],[-58.7854588378378,-27.4466765726269],[-58.7857316010108,-27.44665954315],[-58.7859766178088,-27.4464894971307],[-58.7860270244578,-27.4464798289318],[-58.7860421173879,-27.4464751244674],[-58.7860774310969,-27.4464701607151],[-58.7862034476517,-27.4464459900951],[-58.7863190630901,-27.4464039090155],[-58.7863643418031,-27.4463897955258],[-58.786384489895,-27.4463850261932],[-58.7865505117196,-27.446333276586],[-58.7866913301375,-27.4462863610109],[-58.7867878874527,-27.4463166989543],[-58.7868234191303,-27.4463252650205],[-58.7868981565614,-27.4462566422527],[-58.786938089179,-27.4462245534295],[-58.7870573053186,-27.4460922068902],[-58.7871123306527,-27.4460554134498],[-58.7872828251271,-27.4459675181449],[-58.7873631988646,-27.4459349102865],[-58.7874182240149,-27.445898116733],[-58.7874881964778,-27.4458475985449],[-58.7877629595899,-27.445014060647],[-58.7878979933836,-27.4449221088318],[-58.7879985866498,-27.444889241107],[-58.7880196799058,-27.4449431015431],[-58.7882378502046,-27.4449899211267],[-58.78866637134,-27.4449122442466],[-58.7890995830319,-27.4448119511644],[-58.7895447967102,-27.4448287867672],[-58.7891080866699,-27.4440855819638],[-58.7886702913993,-27.4432747254555],[-58.788461688177,-27.4428804417342],[-58.7881903172037,-27.4423561462905],[-58.7878686172783,-27.4418460289401],[-58.7874354594374,-27.4410080425519],[-58.7873717470031,-27.4408194007087],[-58.7871212604644,-27.440335433161],[-58.7870429332101,-27.4398673005027],[-58.7868443798514,-27.4394683739024],[-58.7867312833927,-27.4393525400646],[-58.7865835296868,-27.4392822599627],[-58.786480180153,-27.4391437462132],[-58.7864285418098,-27.4390767443075],[-58.7861371462506,-27.4388774883277],[-58.7856935540114,-27.438959860843],[-58.7852836751835,-27.4389380483151],[-58.7847737155034,-27.43898066993],[-58.7843401341234,-27.4387426330766],[-58.7840485978685,-27.4385343524703],[-58.7838147695148,-27.4384561496629],[-58.7836337883662,-27.4382058540393],[-58.7833052031712,-27.4378942943816],[-58.7826484007907,-27.4372937225233],[-58.7821586300363,-27.436704543601],[-58.7816312356291,-27.4359760044923],[-58.7813973985448,-27.435582031129],[-58.7812315194223,-27.4353270278942]]]}"
59,393,393,786,220,238,16.35,48,"{""type"":""Polygon"",""coordinates"":[[[-58.7757270972924,-27.4458266135037],[-58.7747154022958,-27.4470619748689],[-58.7750647920442,-27.4474093768026],[-58.7758175229163,-27.4476839717125],[-58.7762828975311,-27.4476960814265],[-58.7768264144543,-27.4478515430637],[-58.7775306964069,-27.4482575639096],[-58.7783180298186,-27.448482082853],[-58.7785822806481,-27.4485644166581],[-58.7788669702149,-27.4486600217411],[-58.7796088108853,-27.4488851141903],[-58.7804266291991,-27.4491182532475],[-58.7806502953349,-27.4491920799209],[-58.781691857629,-27.4495035475845],[-58.7818228424119,-27.4491590405608],[-58.7822313930976,-27.4481523848971],[-58.7823238179461,-27.4479256552678],[-58.7823773230907,-27.4477941533535],[-58.7825233972332,-27.4474449417065],[-58.7825623163504,-27.4473497139076],[-58.7814847337156,-27.4469981142922],[-58.7804432683119,-27.4466911538406],[-58.779401808263,-27.446384185311],[-58.7783499538026,-27.4460592976965],[-58.7781312946714,-27.4466124246048],[-58.7774030469617,-27.4462879092895],[-58.7768706595304,-27.4461954609321],[-58.776063268785,-27.4459802107102],[-58.7757270972924,-27.4458266135037]]]}"
60,965,999,1964,506,533,84.99,23,"{""type"":""Polygon"",""coordinates"":[[[-58.781691857629,-27.4495035475845],[-58.7806502953349,-27.4491920799209],[-58.7804266291991,-27.4491182532475],[-58.7796088108853,-27.4488851141903],[-58.7788669702149,-27.4486600217411],[-58.7785822806481,-27.4485644166581],[-58.7783180298186,-27.448482082853],[-58.7775306964069,-27.4482575639096],[-58.7768264144543,-27.4478515430637],[-58.7762828975311,-27.4476960814265],[-58.7758175229163,-27.4476839717125],[-58.7750647920442,-27.4474093768026],[-58.7747154022958,-27.4470619748689],[-58.7724949953315,-27.4498644841984],[-58.7712230120159,-27.4512700396748],[-58.7702440862252,-27.4523470709731],[-58.7688462160081,-27.4541060608392],[-58.7672348638458,-27.4561158496881],[-58.7678751372298,-27.4559949489767],[-58.7679509724178,-27.4559939862259],[-58.7687494815735,-27.455965802588],[-58.7703152868532,-27.4561714535815],[-58.7712567965354,-27.4562316565425],[-58.7713392299198,-27.4553780384509],[-58.7725094631204,-27.4555120097864],[-58.7723249086415,-27.4566195410967],[-58.7733889138998,-27.4567503455171],[-58.7742855775568,-27.4568516973535],[-58.7750167768784,-27.4570408605046],[-58.7758195534973,-27.4572787273211],[-58.7765775548525,-27.4575622700456],[-58.7769228431682,-27.4567052964836],[-58.7773839647039,-27.4555040122243],[-58.7776702379568,-27.4547515418713],[-58.7779571587496,-27.4540396611996],[-58.7781793672229,-27.4533917594618],[-58.7800237958821,-27.4539455972985],[-58.7801981894178,-27.4534697195731],[-58.7802511198804,-27.4533021382246],[-58.780416921972,-27.4529210997966],[-58.7806243822737,-27.4523004488107],[-58.7807174655433,-27.4521143101684],[-58.7809473739637,-27.4513174451018],[-58.7810554048103,-27.4511175822979],[-58.7812347730369,-27.4506371288515],[-58.7814053336971,-27.4502379847551],[-58.7814685892435,-27.4500838037454],[-58.7815656375101,-27.4498299497942],[-58.7816532995422,-27.449621325243],[-58.781691857629,-27.4495035475845]]]}"
61,822,856,1678,362,359,11.14,151,"{""type"":""Polygon"",""coordinates"":[[[-58.7843882285562,-27.4477007418878],[-58.7839206774404,-27.4475533590833],[-58.7834737837957,-27.4474327757826],[-58.7834574571882,-27.447360809829],[-58.7834256021225,-27.4472664880102],[-58.7833891997371,-27.4472038009703],[-58.783297262376,-27.447146335887],[-58.7832159433756,-27.447120311367],[-58.7831498626464,-27.4470986026567],[-58.7827078092159,-27.4469644220133],[-58.7826252062481,-27.4471729824114],[-58.7825623163504,-27.4473497139076],[-58.7825233972332,-27.4474449417065],[-58.7823773230907,-27.4477941533535],[-58.7823238179461,-27.4479256552678],[-58.7822313930976,-27.4481523848971],[-58.7818228424119,-27.4491590405608],[-58.781691857629,-27.4495035475845],[-58.7816532995422,-27.449621325243],[-58.7815656375101,-27.4498299497942],[-58.7814685892435,-27.4500838037454],[-58.7814053336971,-27.4502379847551],[-58.7812347730369,-27.4506371288515],[-58.7810554048103,-27.4511175822979],[-58.7809473739637,-27.4513174451018],[-58.7807174655433,-27.4521143101684],[-58.7812863595426,-27.4522739397819],[-58.7818858779509,-27.4524512189334],[-58.7825413711481,-27.45265033368],[-58.782885003426,-27.4516941275085],[-58.782894679042,-27.4516669380284],[-58.7832484890247,-27.4507151116975],[-58.783340623339,-27.4504703414411],[-58.783369577006,-27.4503842629148],[-58.7836517583416,-27.4496949871283],[-58.7840302522907,-27.4487067554135],[-58.784029163568,-27.4486391053142],[-58.7842620908511,-27.4480316561526],[-58.7843882285562,-27.4477007418878]]]}"
67,618,670,1288,321,312,23,56,"{""type"":""Polygon"",""coordinates"":[[[-58.7825413711481,-27.45265033368],[-58.7818858779509,-27.4524512189334],[-58.7812863595426,-27.4522739397819],[-58.7807174655433,-27.4521143101684],[-58.7806243822737,-27.4523004488107],[-58.780416921972,-27.4529210997966],[-58.7802511198804,-27.4533021382246],[-58.7801981894178,-27.4534697195731],[-58.7800237958821,-27.4539455972985],[-58.7781793672229,-27.4533917594618],[-58.7779571587496,-27.4540396611996],[-58.7776702379568,-27.4547515418713],[-58.7773839647039,-27.4555040122243],[-58.7769228431682,-27.4567052964836],[-58.7765775548525,-27.4575622700456],[-58.7779450704389,-27.4580139542122],[-58.7779355378513,-27.4580501634398],[-58.7779312057303,-27.4580953281465],[-58.7779268012444,-27.4581359828375],[-58.7779275248701,-27.4581810829922],[-58.7779332318879,-27.4582216085794],[-58.7779389389107,-27.458262134166],[-58.7779497016956,-27.4583025951994],[-58.7779604644892,-27.4583430562313],[-58.7779970850233,-27.4584192746128],[-58.7780280709035,-27.4584594774173],[-58.7780689512298,-27.4584860210545],[-58.7781098315754,-27.4585125646786],[-58.7781506395674,-27.458534598275],[-58.7782318213415,-27.4585516053427],[-58.7782976910757,-27.4585597860315],[-58.7783530873762,-27.458545545754],[-58.7784033555122,-27.4585268600106],[-58.7784484230956,-27.4584992187932],[-58.7784934182695,-27.4584670675483],[-58.7785183351464,-27.4584441946132],[-58.7785483077737,-27.4584212570996],[-58.7785782079987,-27.4583938095664],[-58.7786029800602,-27.4583619165902],[-58.7786226963513,-27.4583300881873],[-58.7786374292685,-27.4583028343734],[-58.7786570007548,-27.4582619859391],[-58.7786864665489,-27.4582074783038],[-58.7803218808096,-27.4586512052786],[-58.7804958444402,-27.4581482671393],[-58.7806161504036,-27.4577678102087],[-58.7809450806624,-27.4568388619407],[-58.7810274755193,-27.4566167722947],[-58.781308307897,-27.4558418102289],[-58.7815549074509,-27.4551394605777],[-58.7818172509032,-27.4544729965846],[-58.7819820337993,-27.4540288164108],[-58.7820497657838,-27.4538384903972],[-58.7821710778255,-27.4535211724893],[-58.7825413711481,-27.45265033368]]]}"
62,527,540,1067,255,254,42.93,25,"{""type"":""Polygon"",""coordinates"":[[[-58.7895447967102,-27.4448287867672],[-58.7890995830319,-27.4448119511644],[-58.78866637134,-27.4449122442466],[-58.7882378502046,-27.4449899211267],[-58.7880196799058,-27.4449431015431],[-58.7879985866498,-27.444889241107],[-58.7878979933836,-27.4449221088318],[-58.7877629595899,-27.445014060647],[-58.7874881964778,-27.4458475985449],[-58.7874182240149,-27.445898116733],[-58.7873631988646,-27.4459349102865],[-58.7872828251271,-27.4459675181449],[-58.7871123306527,-27.4460554134498],[-58.7870573053186,-27.4460922068902],[-58.786938089179,-27.4462245534295],[-58.7868981565614,-27.4462566422527],[-58.7868234191303,-27.4463252650205],[-58.7867878874527,-27.4463166989543],[-58.7866913301375,-27.4462863610109],[-58.7865505117196,-27.446333276586],[-58.786384489895,-27.4463850261932],[-58.7863643418031,-27.4463897955258],[-58.7863190630901,-27.4464039090155],[-58.7862034476517,-27.4464459900951],[-58.7860774310969,-27.4464701607151],[-58.7860421173879,-27.4464751244674],[-58.7860270244578,-27.4464798289318],[-58.7859766178088,-27.4464894971307],[-58.7857316010108,-27.44665954315],[-58.7854588378378,-27.4466765726269],[-58.7852113505872,-27.4466932776205],[-58.7849733201299,-27.446669262563],[-58.7847365966252,-27.4467264272044],[-58.7845142203659,-27.4473608075172],[-58.7843882285562,-27.4477007418878],[-58.7842620908511,-27.4480316561526],[-58.784029163568,-27.4486391053142],[-58.7840302522907,-27.4487067554135],[-58.7836517583416,-27.4496949871283],[-58.783369577006,-27.4503842629148],[-58.783340623339,-27.4504703414411],[-58.7832484890247,-27.4507151116975],[-58.7836599355423,-27.4508316382525],[-58.7840307944445,-27.4509396616031],[-58.7844191088496,-27.4499332594266],[-58.7847849825664,-27.450045855663],[-58.7851962826333,-27.4501533577234],[-58.7852833568205,-27.4499086511872],[-58.7854989507122,-27.4501088794959],[-58.7857713896426,-27.4503850644498],[-58.7859455976373,-27.4505271805096],[-58.7861447923134,-27.4506509321615],[-58.7863636275243,-27.4507383441436],[-58.7865974838553,-27.4508165412163],[-58.7868866590179,-27.4508759844277],[-58.7870808381565,-27.4506885448068],[-58.7874281324074,-27.4505893585747],[-58.7876686812598,-27.4504554542307],[-58.7879664389663,-27.4504200555285],[-58.7883929090877,-27.4505273532265],[-58.7882899826027,-27.450415901612],[-58.7881008241284,-27.4502875133173],[-58.7880143737075,-27.4502570466828],[-58.7879020645752,-27.4501908245078],[-58.7878151778383,-27.4501332977653],[-58.7878599486348,-27.4500876137587],[-58.7879300689028,-27.4500461152529],[-58.7880111727904,-27.450058606866],[-58.788082238737,-27.4500757382321],[-58.7881228998243,-27.4500887489928],[-58.7881989484037,-27.4501013053979],[-58.7883003465326,-27.4501180472054],[-58.7885226366063,-27.4501061709749],[-58.7886387641973,-27.4500956578104],[-58.7888561443697,-27.4500928659618],[-58.7888919685389,-27.450119471405],[-58.7890135153865,-27.4501314429641],[-58.7891146224592,-27.4501301441984],[-58.7892613733003,-27.4501372808436],[-58.7893026169331,-27.4501863711933],[-58.7893384412342,-27.4502129765147],[-58.7894048161135,-27.4502527221009],[-58.7894558793452,-27.4502836425281],[-58.7894768288642,-27.4503284826366],[-58.7894879589093,-27.4503914926178],[-58.7895337484307,-27.45040894799],[-58.7895799020293,-27.4504489533054],[-58.7895653912391,-27.4504897381038],[-58.7895559358094,-27.4505304579442],[-58.7895361511949,-27.4505577777217],[-58.7895619377405,-27.4505890228799],[-58.7895977622359,-27.4506156281238],[-58.7896845774071,-27.4506686436962],[-58.789725384515,-27.450690673951],[-58.7897562993445,-27.4507263640961],[-58.7897771034334,-27.4507621841647],[-58.7898083095928,-27.4508159142602],[-58.7898343147496,-27.4508606893331],[-58.7898607568821,-27.4509325243445],[-58.7898463189696,-27.4509778191584],[-58.7898167148697,-27.4510233088745],[-58.7897720902079,-27.4510780134659],[-58.7897576522432,-27.4511233082723],[-58.7897734010162,-27.4511591933015],[-58.7898142811513,-27.45118573351],[-58.7898501059049,-27.4512123386747],[-58.7898757470445,-27.4512345637794],[-58.7899167728892,-27.4512701239359],[-58.7902866185643,-27.451314990398],[-58.7905843045352,-27.4512750760412],[-58.7909031866007,-27.45098227669],[-58.7914263488443,-27.4505019013215],[-58.791776870791,-27.4502898897625],[-58.7921152148525,-27.4502629819398],[-58.7923997001061,-27.4503450286059],[-58.7929801468961,-27.4509059335727],[-58.7935135156081,-27.4510569483055],[-58.7939581703152,-27.4510376887001],[-58.7943703022298,-27.450883519094],[-58.7941360215167,-27.4504670216959],[-58.7933345650701,-27.4493721677776],[-58.7927035950576,-27.4485006605086],[-58.7919801580073,-27.4478513749584],[-58.7911093542817,-27.446843106218],[-58.791068111214,-27.4467940163599],[-58.7899347787317,-27.4454959045933],[-58.7895447967102,-27.4448287867672]]]}"
63,838,820,1658,385,379,90.52,18,"{""type"":""Polygon"",""coordinates"":[[[-58.7883929090877,-27.4505273532265],[-58.7884649941356,-27.4506076243018],[-58.7885268957575,-27.4506835151799],[-58.7887292229054,-27.4510011927089],[-58.7888177120333,-27.45115793867],[-58.7889365338695,-27.4513142949456],[-58.788993162439,-27.4513767205331],[-58.789553304001,-27.4519333900418],[-58.7896409940641,-27.4520405254714],[-58.7886635864702,-27.4522605845899],[-58.7887501509321,-27.4526113251314],[-58.788777903029,-27.4527643402063],[-58.7888218407143,-27.4529803003517],[-58.7888711980517,-27.4532187454896],[-58.7889932658848,-27.453889305503],[-58.7890652487666,-27.4542763204179],[-58.7892796717694,-27.4553426548964],[-58.7894735128077,-27.4563866986197],[-58.7896617196885,-27.4573947268289],[-58.7897560431436,-27.4579122706841],[-58.7898450933469,-27.4584163494236],[-58.7900434925468,-27.4594287565215],[-58.7900709572444,-27.4595637310905],[-58.7902326587165,-27.4604954128339],[-58.790582093546,-27.4605270070379],[-58.7907963280384,-27.4615798070478],[-58.7909965659636,-27.462704961175],[-58.7911841445043,-27.4636723954652],[-58.791387551216,-27.4646802238594],[-58.791586124933,-27.465701646635],[-58.7917197985245,-27.4664622710635],[-58.7913969380191,-27.4665115349482],[-58.7915223459786,-27.4670737856041],[-58.7919490299122,-27.4671900888811],[-58.7927817377523,-27.4673958919835],[-58.7935280559043,-27.4675757375015],[-58.7945740769985,-27.4678374231942],[-58.7955489508765,-27.4680774639465],[-58.7954602419302,-27.4672846880898],[-58.7953984231934,-27.4665908052869],[-58.7953313301521,-27.4658834576511],[-58.7952542723718,-27.4651852602017],[-58.7951668845919,-27.4644736630722],[-58.7950998681993,-27.4637708249574],[-58.7950381280735,-27.4630814514293],[-58.7949777042259,-27.4624732572441],[-58.7949278313817,-27.4618919924245],[-58.7947873490173,-27.4607119439873],[-58.7947541069691,-27.4602206828289],[-58.79469514817,-27.4597026875966],[-58.794636336158,-27.4591937122236],[-58.7945935685197,-27.4587386609811],[-58.7945391561108,-27.4581890305262],[-58.7944850365435,-27.457657439883],[-58.7944847444048,-27.457639399983],[-58.7944488598291,-27.4572970327734],[-58.7944361923991,-27.4571393139332],[-58.7944303334019,-27.4570897693514],[-58.7943641717034,-27.4570635564081],[-58.7943092167283,-27.4571048627818],[-58.7942793209331,-27.4571323134964],[-58.7942338930292,-27.4571374097499],[-58.7941724218989,-27.4570885816931],[-58.7941310274044,-27.4570304731064],[-58.7941202589352,-27.4569900135937],[-58.7940993061567,-27.4569451743751],[-58.7940580577872,-27.4568960857143],[-58.7940321954346,-27.4568603315702],[-58.7940058950236,-27.4567975175602],[-58.7939949806034,-27.4567480380796],[-58.7939790105547,-27.4566986237284],[-58.7939480926387,-27.4566629346951],[-58.7939373242793,-27.4566224751612],[-58.7939316845718,-27.4565864604741],[-58.7938659613215,-27.4565873071352],[-58.7937745218788,-27.4565614195194],[-58.7937187639056,-27.4565531159084],[-58.7936729712097,-27.4565356620806],[-58.793712540276,-27.4564810213874],[-58.7937472726791,-27.4564399757391],[-58.7937310107916,-27.4563725214393],[-58.7937872981753,-27.4561011413139],[-58.7938601391928,-27.4559152553719],[-58.7940764527337,-27.4555335516104],[-58.7941137934244,-27.4547165943498],[-58.7942642916153,-27.4546424806829],[-58.7945878464569,-27.454638311552],[-58.7949946273893,-27.4547774183027],[-58.7956211364225,-27.4550580401256],[-58.7972875955518,-27.4539854996838],[-58.7970296282264,-27.4536685537575],[-58.7962982135043,-27.4531547235991],[-58.7958540161335,-27.4525785440215],[-58.7954577331461,-27.4521506054127],[-58.7945316187915,-27.4511656285872],[-58.7943703022298,-27.450883519094],[-58.7939581703152,-27.4510376887001],[-58.7935135156081,-27.4510569483055],[-58.7929801468961,-27.4509059335727],[-58.7923997001061,-27.4503450286059],[-58.7921152148525,-27.4502629819398],[-58.791776870791,-27.4502898897625],[-58.7914263488443,-27.4505019013215],[-58.7909031866007,-27.45098227669],[-58.7905843045352,-27.4512750760412],[-58.7902866185643,-27.451314990398],[-58.7899167728892,-27.4512701239359],[-58.7898757470445,-27.4512345637794],[-58.7898501059049,-27.4512123386747],[-58.7898142811513,-27.45118573351],[-58.7897734010162,-27.4511591933015],[-58.7897576522432,-27.4511233082723],[-58.7897720902079,-27.4510780134659],[-58.7898167148697,-27.4510233088745],[-58.7898463189696,-27.4509778191584],[-58.7898607568821,-27.4509325243445],[-58.7898343147496,-27.4508606893331],[-58.7898083095928,-27.4508159142602],[-58.7897771034334,-27.4507621841647],[-58.7897562993445,-27.4507263640961],[-58.789725384515,-27.450690673951],[-58.7896845774071,-27.4506686436962],[-58.7895977622359,-27.4506156281238],[-58.7895619377405,-27.4505890228799],[-58.7895361511949,-27.4505577777217],[-58.7895559358094,-27.4505304579442],[-58.7895653912391,-27.4504897381038],[-58.7895799020293,-27.4504489533054],[-58.7895337484307,-27.45040894799],[-58.7894879589093,-27.4503914926178],[-58.7894768288642,-27.4503284826366],[-58.7894558793452,-27.4502836425281],[-58.7894048161135,-27.4502527221009],[-58.7893384412342,-27.4502129765147],[-58.7893026169331,-27.4501863711933],[-58.7892613733003,-27.4501372808436],[-58.7891146224592,-27.4501301441984],[-58.7890135153865,-27.4501314429641],[-58.7888919685389,-27.450119471405],[-58.7888561443697,-27.4500928659618],[-58.7886387641973,-27.4500956578104],[-58.7885226366063,-27.4501061709749],[-58.7883003465326,-27.4501180472054],[-58.7881989484037,-27.4501013053979],[-58.7881228998243,-27.4500887489928],[-58.788082238737,-27.4500757382321],[-58.7880111727904,-27.450058606866],[-58.7879300689028,-27.4500461152529],[-58.7878599486348,-27.4500876137587],[-58.7878151778383,-27.4501332977653],[-58.7879020645752,-27.4501908245078],[-58.7880143737075,-27.4502570466828],[-58.7881008241284,-27.4502875133173],[-58.7882899826027,-27.450415901612],[-58.7883929090877,-27.4505273532265]]]}"
68,946,961,1907,505,501,58.25,33,"{""type"":""Polygon"",""coordinates"":[[[-58.7765775548525,-27.4575622700456],[-58.7758195534973,-27.4572787273211],[-58.7750167768784,-27.4570408605046],[-58.7742855775568,-27.4568516973535],[-58.7733889138998,-27.4567503455171],[-58.7723249086415,-27.4566195410967],[-58.7725094631204,-27.4555120097864],[-58.7713392299198,-27.4553780384509],[-58.7712567965354,-27.4562316565425],[-58.7703152868532,-27.4561714535815],[-58.7687494815735,-27.455965802588],[-58.7679509724178,-27.4559939862259],[-58.7678751372298,-27.4559949489767],[-58.7672348638458,-27.4561158496881],[-58.7671608265046,-27.4562295631303],[-58.7652123020515,-27.4586631276395],[-58.7648994610194,-27.4590234587177],[-58.7657850431359,-27.4596978967957],[-58.7663580569944,-27.4601146588759],[-58.7675404961321,-27.4610108665653],[-58.768805321008,-27.4613647028429],[-58.7696581013197,-27.4615658816466],[-58.7717350620303,-27.4621078480665],[-58.7725421323408,-27.4622960575902],[-58.7732734379148,-27.4624897382221],[-58.7739286896806,-27.4626708510805],[-58.7746699672191,-27.4628553752572],[-58.7751116320058,-27.4613836892584],[-58.7753761927178,-27.4605367701657],[-58.7758529459279,-27.4593623567902],[-58.7762525569013,-27.4584234949599],[-58.7765775548525,-27.4575622700456]]]}"
69,416,450,866,244,221,11.52,75,"{""type"":""Polygon"",""coordinates"":[[[-58.7803218808096,-27.4586512052786],[-58.7786864665489,-27.4582074783038],[-58.7786570007548,-27.4582619859391],[-58.7786374292685,-27.4583028343734],[-58.7786226963513,-27.4583300881873],[-58.7786029800602,-27.4583619165902],[-58.7785782079987,-27.4583938095664],[-58.7785483077737,-27.4584212570996],[-58.7785183351464,-27.4584441946132],[-58.7784934182695,-27.4584670675483],[-58.7784484230956,-27.4584992187932],[-58.7784033555122,-27.4585268600106],[-58.7783530873762,-27.458545545754],[-58.7782976910757,-27.4585597860315],[-58.7782318213415,-27.4585516053427],[-58.7781506395674,-27.458534598275],[-58.7781098315754,-27.4585125646786],[-58.7780689512298,-27.4584860210545],[-58.7780280709035,-27.4584594774173],[-58.7779970850233,-27.4584192746128],[-58.7779604644892,-27.4583430562313],[-58.7779497016956,-27.4583025951994],[-58.7779389389107,-27.458262134166],[-58.7779332318879,-27.4582216085794],[-58.7779275248701,-27.4581810829922],[-58.7779268012444,-27.4581359828375],[-58.7779312057303,-27.4580953281465],[-58.7779355378513,-27.4580501634398],[-58.7779450704389,-27.4580139542122],[-58.7765775548525,-27.4575622700456],[-58.7762525569013,-27.4584234949599],[-58.7758529459279,-27.4593623567902],[-58.7753761927178,-27.4605367701657],[-58.7762117117703,-27.4606073114294],[-58.7772496109738,-27.4606842865106],[-58.7775534694805,-27.4607119843423],[-58.7784953084985,-27.460790176337],[-58.7790221325888,-27.4608465994085],[-58.7796291990729,-27.46086139649],[-58.7796330809845,-27.4604734064212],[-58.7799607222158,-27.4594632798728],[-58.7803218808096,-27.4586512052786]]]}"
70,534,531,1065,268,265,21.68,49,"{""type"":""Polygon"",""coordinates"":[[[-58.7857571193098,-27.457972632733],[-58.7850812509982,-27.458080538971],[-58.7844051633006,-27.4581749119896],[-58.7837695927752,-27.4582732736745],[-58.7831236917368,-27.4583582319834],[-58.7829470309131,-27.4583785378021],[-58.7828009221843,-27.4584119850395],[-58.7827052983051,-27.4584402748777],[-58.7826345903566,-27.458445691021],[-58.782468185868,-27.4584748868042],[-58.7823472105235,-27.4584989899815],[-58.782141012631,-27.4585692931199],[-58.7820653938623,-27.4585837936943],[-58.7819587152361,-27.4585535823718],[-58.781262741353,-27.4583549840447],[-58.7804958444402,-27.4581482671393],[-58.7803218808096,-27.4586512052786],[-58.7799607222158,-27.4594632798728],[-58.7796330809845,-27.4604734064212],[-58.7796291990729,-27.46086139649],[-58.780323012469,-27.4609247020753],[-58.7810413083311,-27.4609380707463],[-58.7815786081897,-27.4610169047278],[-58.7818569711817,-27.4610313865045],[-58.7822769711307,-27.4610485657583],[-58.7826873673514,-27.4610974432132],[-58.7829456522253,-27.4611212017196],[-58.7836190268632,-27.4611712196635],[-58.7839836305631,-27.461202636125],[-58.7842722510554,-27.4612260034733],[-58.7849611574602,-27.4612983704801],[-58.7856955674444,-27.4613701504768],[-58.7859183894394,-27.4613898472894],[-58.7866427613246,-27.4614662619178],[-58.7870389021299,-27.4612581866253],[-58.7867900051484,-27.459935168774],[-58.7865864330294,-27.4589138006118],[-58.7864867765383,-27.4583782788986],[-58.7863981050631,-27.4578967472507],[-58.7857571193098,-27.457972632733]]]}"
71,566,623,1189,330,371,15.93,75,"{""type"":""Polygon"",""coordinates"":[[[-58.7894735128077,-27.4563866986197],[-58.788827847049,-27.4564852126545],[-58.7882630703704,-27.4565826849997],[-58.7876223122176,-27.4566721086378],[-58.7869310689637,-27.4567666881305],[-58.7861793743898,-27.4568755724253],[-58.7855640360136,-27.4569736824955],[-58.7857571193098,-27.457972632733],[-58.7863981050631,-27.4578967472507],[-58.7864867765383,-27.4583782788986],[-58.7865864330294,-27.4589138006118],[-58.7867900051484,-27.459935168774],[-58.7870389021299,-27.4612581866253],[-58.7872344804023,-27.4611564360239],[-58.7877609067002,-27.4608745115969],[-58.7883961961905,-27.4607580912255],[-58.7890419599572,-27.4606640880285],[-58.7891484966034,-27.4606852737516],[-58.7896124677951,-27.4606071365008],[-58.789687795301,-27.4605745918713],[-58.7902326587165,-27.4604954128339],[-58.7900709572444,-27.4595637310905],[-58.7900434925468,-27.4594287565215],[-58.7898450933469,-27.4584163494236],[-58.7897560431436,-27.4579122706841],[-58.7896617196885,-27.4573947268289],[-58.7894735128077,-27.4563866986197]]]}"
282,412,438,850,253,243,10.21,83,"{""type"":""Polygon"",""coordinates"":[[[-58.8398399074239,-27.481482773186],[-58.8387399562996,-27.4816416574374],[-58.8372714639122,-27.4818414857919],[-58.8373670837988,-27.4824221217427],[-58.8374476095827,-27.4830074676862],[-58.8376085893967,-27.4841736493181],[-58.8377505441889,-27.4854122551248],[-58.8379576494071,-27.4853959872987],[-58.8386692381649,-27.4853008808511],[-58.8393909391057,-27.4852056371366],[-58.8399411569765,-27.4851397222271],[-58.8402591359905,-27.4850994307816],[-58.8403247994747,-27.4850940515614],[-58.8401569330941,-27.4838197053141],[-58.8399810571238,-27.4826717678224],[-58.8398399074239,-27.481482773186]]]}"
64,896,894,1790,403,376,18.62,96,"{""type"":""Polygon"",""coordinates"":[[[-58.7883929090877,-27.4505273532265],[-58.7883427919274,-27.4505550623339],[-58.7882975845958,-27.4505736865232],[-58.7882426302885,-27.4506149904927],[-58.7881526520563,-27.450679298767],[-58.7881126455294,-27.4507068779837],[-58.788097988655,-27.4507386426648],[-58.7880583458524,-27.4507887718439],[-58.7880391428237,-27.4508521713901],[-58.7880755490894,-27.4509148570001],[-58.7880411071161,-27.4509739412627],[-58.7879916444142,-27.4510422402135],[-58.7879111217753,-27.4510658285892],[-58.7878403461812,-27.4510667371499],[-58.7877800450911,-27.4510900658666],[-58.7876793734941,-27.4511184236817],[-58.7875943044589,-27.451173646743],[-58.7875651357575,-27.4512461960032],[-58.7875618259475,-27.4513545007985],[-58.7875079619513,-27.4514634544486],[-58.7873984154638,-27.4515686117868],[-58.7873335676521,-27.4516235751828],[-58.7872843951261,-27.4517099138974],[-58.7873330211975,-27.4519032598432],[-58.7873180730555,-27.4519169844696],[-58.7873031249099,-27.4519307090945],[-58.7872882494847,-27.4519489437144],[-58.7872783567732,-27.4519626034591],[-58.7872736649495,-27.4519852183188],[-58.7872689004005,-27.4520033231821],[-58.7872591531286,-27.4520260029186],[-58.7872442776841,-27.4520442375345],[-58.7872345304039,-27.4520669172696],[-58.7872145995022,-27.4520852167588],[-58.7872097622187,-27.4520988116238],[-58.7872051430981,-27.4521259364784],[-58.7872003058119,-27.4521395313431],[-58.787195759409,-27.4521711661939],[-58.7871862302715,-27.4522073759159],[-58.7872015420749,-27.4522162012841],[-58.7872271102343,-27.4522339168915],[-58.7872573702378,-27.4522290176347],[-58.7872775920549,-27.4522287581241],[-58.7873028693259,-27.4522284337318],[-58.7873178902357,-27.4522192191018],[-58.7873431675039,-27.4522188947022],[-58.7873787011362,-27.4522274605273],[-58.787414089313,-27.452227006351],[-58.7874292556743,-27.4522268117013],[-58.7874496229523,-27.4522355721576],[-58.7874648620467,-27.4522398874998],[-58.7874701356985,-27.4522533526024],[-58.787480610273,-27.4522757728108],[-58.7874608248433,-27.4523030923262],[-58.787445876667,-27.4523168169674],[-58.7874359112141,-27.4523259667273],[-58.7874210357625,-27.452344201362],[-58.7874112157661,-27.4523623711121],[-58.787386083925,-27.4523717155175],[-58.7873659348117,-27.452376485041],[-58.7873457856966,-27.4523812545617],[-58.7873106156486,-27.4523952387114],[-58.7872854837906,-27.4524045830993],[-58.7872653346663,-27.4524093526087],[-58.7872352200614,-27.4524232718621],[-58.7872151436538,-27.4524325513608],[-58.7871900845002,-27.4524464057286],[-58.7871801917355,-27.4524600654681],[-58.7871702262474,-27.4524692152105],[-58.7871705171315,-27.4524872551962],[-58.7871707352948,-27.4525007851854],[-58.7871710261795,-27.452518825171],[-58.7871662615958,-27.4525369300312],[-58.7871716806709,-27.4525594151383],[-58.7871771724701,-27.4525864102413],[-58.7871773906352,-27.4525999402303],[-58.7871828824384,-27.4526269353328],[-58.7871884469669,-27.4526584404311],[-58.7871887378564,-27.4526764804161],[-58.7871944478355,-27.4527170055062],[-58.7871797904607,-27.4527487701071],[-58.7871701158356,-27.4527759598352],[-58.787150112081,-27.4527897493238],[-58.7871200700797,-27.4528081785534],[-58.7871049763558,-27.4528128831696],[-58.7870848998675,-27.452822162653],[-58.7870648233757,-27.4528314421337],[-58.7870245249492,-27.4528409810936],[-58.7870043030176,-27.4528412405728],[-58.7869891365688,-27.4528414351802],[-58.786974042834,-27.4528461397827],[-58.7869538936143,-27.4528509092513],[-58.7869387998766,-27.45285561385],[-58.7869239242741,-27.4528738484375],[-58.7869140314403,-27.4528875081606],[-58.7868891175683,-27.4529103824737],[-58.7868741692401,-27.4529241070597],[-58.7868592209082,-27.4529378316441],[-58.7868392170842,-27.4529516210909],[-58.786809102277,-27.4529655402606],[-58.7867988458838,-27.4529566499915],[-58.7867632393443,-27.4529435740312],[-58.7867481455848,-27.4529482786102],[-58.7867331245287,-27.4529574931848],[-58.7867182488783,-27.4529757277523],[-58.7867134842046,-27.4529938326004],[-58.7867238132994,-27.4530072328732],[-58.7867340696917,-27.4530161231479],[-58.7867494542834,-27.4530294585584],[-58.7867597106799,-27.453038348831],[-58.7867650569977,-27.4530563239581],[-58.7867703306108,-27.4530697890878],[-58.7867553822468,-27.4530835136624],[-58.7867405792901,-27.4531062582297],[-58.7867256309176,-27.4531199828015],[-58.786715810743,-27.4531381525094],[-58.7867059178611,-27.4531518122196],[-58.7866960249768,-27.4531654719292],[-58.786691260293,-27.4531835767766],[-58.7866865683115,-27.453206191621],[-58.7866818763284,-27.4532288064653],[-58.7866822398461,-27.4532513564509],[-58.7866776932676,-27.4532829912893],[-58.7866680911816,-27.4533146909858],[-58.7866633991914,-27.4533373058296],[-58.7866487415896,-27.4533690703831],[-58.7866389213824,-27.4533872400866],[-58.7866291011722,-27.4534054097896],[-58.7866140073443,-27.453410114357],[-58.7865835288844,-27.4534014834981],[-58.7865729816676,-27.4533745532247],[-58.7865627252526,-27.4533656629395],[-58.7865523961405,-27.4533522626561],[-58.7865167167993,-27.4533346766407],[-58.7864660163407,-27.4533263051643],[-58.7864408115019,-27.4533311394144],[-58.7864155339676,-27.4533314636623],[-58.7864003674468,-27.4533316582088],[-58.7863852009259,-27.4533318527537],[-58.7863650515887,-27.4533366221422],[-58.7863347912345,-27.4533415212206],[-58.7863095136964,-27.4533418454493],[-58.7862891462899,-27.453333084833],[-58.7862586678724,-27.4533244539007],[-58.7861933823836,-27.4533523568391],[-58.7861426819342,-27.4533439852442],[-58.7860765969299,-27.4533222781461],[-58.786021277055,-27.4533410313346],[-58.7860014184022,-27.4533638406661],[-58.7859820684701,-27.4534182199864],[-58.7859370775778,-27.453450373473],[-58.7858867404561,-27.4534645517808],[-58.7858574247599,-27.4535280807447],[-58.7858228355026,-27.4535781445347],[-58.7857882462149,-27.4536282083172],[-58.7857186315532,-27.4537012758648],[-58.7856890250451,-27.4537467648019],[-58.7856798586268,-27.4538055244391],[-58.7857007347376,-27.4538458551363],[-58.7857413969971,-27.4538588665332],[-58.7857419056679,-27.4538904365264],[-58.7857525254108,-27.4539218768672],[-58.7857174999931,-27.4539448806423],[-58.7856673079466,-27.4539680788802],[-58.7856374833617,-27.4540000378115],[-58.7856228253829,-27.4540318022723],[-58.7855979836491,-27.454059186375],[-58.7855679410379,-27.4540776152952],[-58.7855118214515,-27.4540467583076],[-58.7854962188788,-27.4540198927631],[-58.7854456634697,-27.4540205409265],[-58.7854208216926,-27.4540479249996],[-58.7853762663,-27.4541071383207],[-58.7853569159479,-27.4541615175694],[-58.7853426937806,-27.4542203420036],[-58.7853330185901,-27.4542475316263],[-58.7853438562162,-27.4542925019998],[-58.7852795870141,-27.4543835445418],[-58.7852500528035,-27.4544335433985],[-58.7852154630044,-27.4544836070579],[-58.7851805099428,-27.45451112071],[-58.7851360268905,-27.4545748439656],[-58.7851323515733,-27.4546605987719],[-58.7851384968228,-27.4547281839662],[-58.7850941589533,-27.4548009272118],[-58.7850848468762,-27.4548506668205],[-58.7850857912438,-27.4549092968205],[-58.7852017790435,-27.4548897662747],[-58.7853601915395,-27.4559342713336],[-58.7855640360136,-27.4569736824955],[-58.7861793743898,-27.4568755724253],[-58.7869310689637,-27.4567666881305],[-58.7876223122176,-27.4566721086378],[-58.7882630703704,-27.4565826849997],[-58.788827847049,-27.4564852126545],[-58.7894735128077,-27.4563866986197],[-58.7892796717694,-27.4553426548964],[-58.7890652487666,-27.4542763204179],[-58.7889932658848,-27.453889305503],[-58.7888711980517,-27.4532187454896],[-58.7888218407143,-27.4529803003517],[-58.788777903029,-27.4527643402063],[-58.7887501509321,-27.4526113251314],[-58.7886635864702,-27.4522605845899],[-58.7896409940641,-27.4520405254714],[-58.789553304001,-27.4519333900418],[-58.788993162439,-27.4513767205331],[-58.7889365338695,-27.4513142949456],[-58.7888177120333,-27.45115793867],[-58.7887292229054,-27.4510011927089],[-58.7885268957575,-27.4506835151799],[-58.7884649941356,-27.4506076243018],[-58.7883929090877,-27.4505273532265]]]}"
65,484,496,980,244,273,13.51,73,"{""type"":""Polygon"",""coordinates"":[[[-58.7883929090877,-27.4505273532265],[-58.7879664389663,-27.4504200555285],[-58.7876686812598,-27.4504554542307],[-58.7874281324074,-27.4505893585747],[-58.7870808381565,-27.4506885448068],[-58.7868866590179,-27.4508759844277],[-58.7865974838553,-27.4508165412163],[-58.7863636275243,-27.4507383441436],[-58.7861447923134,-27.4506509321615],[-58.7859455976373,-27.4505271805096],[-58.7857713896426,-27.4503850644498],[-58.7854989507122,-27.4501088794959],[-58.7852833568205,-27.4499086511872],[-58.7851962826333,-27.4501533577234],[-58.7847849825664,-27.450045855663],[-58.7844191088496,-27.4499332594266],[-58.7840307944445,-27.4509396616031],[-58.7836599355423,-27.4508316382525],[-58.7832484890247,-27.4507151116975],[-58.782894679042,-27.4516669380284],[-58.782885003426,-27.4516941275085],[-58.7825413711481,-27.45265033368],[-58.7833339453941,-27.4528837774561],[-58.7840961897186,-27.4531176051433],[-58.784431377762,-27.453208040345],[-58.7848425442139,-27.4533065228569],[-58.7851879170096,-27.4534013365945],[-58.7858228355026,-27.4535781445347],[-58.7858574247599,-27.4535280807447],[-58.7858867404561,-27.4534645517808],[-58.7859370775778,-27.453450373473],[-58.7859820684701,-27.4534182199864],[-58.7860014184022,-27.4533638406661],[-58.786021277055,-27.4533410313346],[-58.7860765969299,-27.4533222781461],[-58.7861426819342,-27.4533439852442],[-58.7861933823836,-27.4533523568391],[-58.7862586678724,-27.4533244539007],[-58.7862891462899,-27.453333084833],[-58.7863095136964,-27.4533418454493],[-58.7863347912345,-27.4533415212206],[-58.7863650515887,-27.4533366221422],[-58.7863852009259,-27.4533318527537],[-58.7864003674468,-27.4533316582088],[-58.7864155339676,-27.4533314636623],[-58.7864408115019,-27.4533311394144],[-58.7864660163407,-27.4533263051643],[-58.7865167167993,-27.4533346766407],[-58.7865523961405,-27.4533522626561],[-58.7865627252526,-27.4533656629395],[-58.7865729816676,-27.4533745532247],[-58.7865835288844,-27.4534014834981],[-58.7866140073443,-27.453410114357],[-58.7866291011722,-27.4534054097896],[-58.7866389213824,-27.4533872400866],[-58.7866487415896,-27.4533690703831],[-58.7866633991914,-27.4533373058296],[-58.7866680911816,-27.4533146909858],[-58.7866776932676,-27.4532829912893],[-58.7866822398461,-27.4532513564509],[-58.7866818763284,-27.4532288064653],[-58.7866865683115,-27.453206191621],[-58.786691260293,-27.4531835767766],[-58.7866960249768,-27.4531654719292],[-58.7867059178611,-27.4531518122196],[-58.786715810743,-27.4531381525094],[-58.7867256309176,-27.4531199828015],[-58.7867405792901,-27.4531062582297],[-58.7867553822468,-27.4530835136624],[-58.7867703306108,-27.4530697890878],[-58.7867650569977,-27.4530563239581],[-58.7867597106799,-27.453038348831],[-58.7867494542834,-27.4530294585584],[-58.7867340696917,-27.4530161231479],[-58.7867238132994,-27.4530072328732],[-58.7867134842046,-27.4529938326004],[-58.7867182488783,-27.4529757277523],[-58.7867331245287,-27.4529574931848],[-58.7867481455848,-27.4529482786102],[-58.7867632393443,-27.4529435740312],[-58.7867988458838,-27.4529566499915],[-58.786809102277,-27.4529655402606],[-58.7868392170842,-27.4529516210909],[-58.7868592209082,-27.4529378316441],[-58.7868741692401,-27.4529241070597],[-58.7868891175683,-27.4529103824737],[-58.7869140314403,-27.4528875081606],[-58.7869239242741,-27.4528738484375],[-58.7869387998766,-27.45285561385],[-58.7869538936143,-27.4528509092513],[-58.786974042834,-27.4528461397827],[-58.7869891365688,-27.4528414351802],[-58.7870043030176,-27.4528412405728],[-58.7870245249492,-27.4528409810936],[-58.7870648233757,-27.4528314421337],[-58.7870848998675,-27.452822162653],[-58.7871049763558,-27.4528128831696],[-58.7871200700797,-27.4528081785534],[-58.787150112081,-27.4527897493238],[-58.7871701158356,-27.4527759598352],[-58.7871797904607,-27.4527487701071],[-58.7871944478355,-27.4527170055062],[-58.7871887378564,-27.4526764804161],[-58.7871884469669,-27.4526584404311],[-58.7871828824384,-27.4526269353328],[-58.7871773906352,-27.4525999402303],[-58.7871771724701,-27.4525864102413],[-58.7871716806709,-27.4525594151383],[-58.7871662615958,-27.4525369300312],[-58.7871710261795,-27.452518825171],[-58.7871707352948,-27.4525007851854],[-58.7871705171315,-27.4524872551962],[-58.7871702262474,-27.4524692152105],[-58.7871801917355,-27.4524600654681],[-58.7871900845002,-27.4524464057286],[-58.7872151436538,-27.4524325513608],[-58.7872352200614,-27.4524232718621],[-58.7872653346663,-27.4524093526087],[-58.7872854837906,-27.4524045830993],[-58.7873106156486,-27.4523952387114],[-58.7873457856966,-27.4523812545617],[-58.7873659348117,-27.452376485041],[-58.787386083925,-27.4523717155175],[-58.7874112157661,-27.4523623711121],[-58.7874210357625,-27.452344201362],[-58.7874359112141,-27.4523259667273],[-58.787445876667,-27.4523168169674],[-58.7874608248433,-27.4523030923262],[-58.787480610273,-27.4522757728108],[-58.7874701356985,-27.4522533526024],[-58.7874648620467,-27.4522398874998],[-58.7874496229523,-27.4522355721576],[-58.7874292556743,-27.4522268117013],[-58.787414089313,-27.452227006351],[-58.7873787011362,-27.4522274605273],[-58.7873431675039,-27.4522188947022],[-58.7873178902357,-27.4522192191018],[-58.7873028693259,-27.4522284337318],[-58.7872775920549,-27.4522287581241],[-58.7872573702378,-27.4522290176347],[-58.7872271102343,-27.4522339168915],[-58.7872015420749,-27.4522162012841],[-58.7871862302715,-27.4522073759159],[-58.787195759409,-27.4521711661939],[-58.7872003058119,-27.4521395313431],[-58.7872051430981,-27.4521259364784],[-58.7872097622187,-27.4520988116238],[-58.7872145995022,-27.4520852167588],[-58.7872345304039,-27.4520669172696],[-58.7872442776841,-27.4520442375345],[-58.7872591531286,-27.4520260029186],[-58.7872689004005,-27.4520033231821],[-58.7872736649495,-27.4519852183188],[-58.7872783567732,-27.4519626034591],[-58.7872882494847,-27.4519489437144],[-58.7873031249099,-27.4519307090945],[-58.7873180730555,-27.4519169844696],[-58.7873330211975,-27.4519032598432],[-58.7872843951261,-27.4517099138974],[-58.7873335676521,-27.4516235751828],[-58.7873984154638,-27.4515686117868],[-58.7875079619513,-27.4514634544486],[-58.7875618259475,-27.4513545007985],[-58.7875651357575,-27.4512461960032],[-58.7875943044589,-27.451173646743],[-58.7876793734941,-27.4511184236817],[-58.7877800450911,-27.4510900658666],[-58.7878403461812,-27.4510667371499],[-58.7879111217753,-27.4510658285892],[-58.7879916444142,-27.4510422402135],[-58.7880411071161,-27.4509739412627],[-58.7880755490894,-27.4509148570001],[-58.7880391428237,-27.4508521713901],[-58.7880583458524,-27.4507887718439],[-58.788097988655,-27.4507386426648],[-58.7881126455294,-27.4507068779837],[-58.7881526520563,-27.450679298767],[-58.7882426302885,-27.4506149904927],[-58.7882975845958,-27.4505736865232],[-58.7883427919274,-27.4505550623339],[-58.7883929090877,-27.4505273532265]]]}"
66,642,695,1337,323,321,23.42,57,"{""type"":""Polygon"",""coordinates"":[[[-58.7858228355026,-27.4535781445347],[-58.7851879170096,-27.4534013365945],[-58.7848425442139,-27.4533065228569],[-58.784431377762,-27.453208040345],[-58.7840961897186,-27.4531176051433],[-58.7833339453941,-27.4528837774561],[-58.7825413711481,-27.45265033368],[-58.7821710778255,-27.4535211724893],[-58.7820497657838,-27.4538384903972],[-58.7819820337993,-27.4540288164108],[-58.7818172509032,-27.4544729965846],[-58.7815549074509,-27.4551394605777],[-58.781308307897,-27.4558418102289],[-58.7810274755193,-27.4566167722947],[-58.7809450806624,-27.4568388619407],[-58.7806161504036,-27.4577678102087],[-58.7804958444402,-27.4581482671393],[-58.781262741353,-27.4583549840447],[-58.7819587152361,-27.4585535823718],[-58.7820653938623,-27.4585837936943],[-58.782141012631,-27.4585692931199],[-58.7823472105235,-27.4584989899815],[-58.782468185868,-27.4584748868042],[-58.7826345903566,-27.458445691021],[-58.7827052983051,-27.4584402748777],[-58.7828009221843,-27.4584119850395],[-58.7829470309131,-27.4583785378021],[-58.7831236917368,-27.4583582319834],[-58.7837695927752,-27.4582732736745],[-58.7844051633006,-27.4581749119896],[-58.7850812509982,-27.458080538971],[-58.7857571193098,-27.457972632733],[-58.7855640360136,-27.4569736824955],[-58.7853601915395,-27.4559342713336],[-58.7852017790435,-27.4548897662747],[-58.7850857912438,-27.4549092968205],[-58.7850848468762,-27.4548506668205],[-58.7850941589533,-27.4548009272118],[-58.7851384968228,-27.4547281839662],[-58.7851323515733,-27.4546605987719],[-58.7851360268905,-27.4545748439656],[-58.7851805099428,-27.45451112071],[-58.7852154630044,-27.4544836070579],[-58.7852500528035,-27.4544335433985],[-58.7852795870141,-27.4543835445418],[-58.7853438562162,-27.4542925019998],[-58.7853330185901,-27.4542475316263],[-58.7853426937806,-27.4542203420036],[-58.7853569159479,-27.4541615175694],[-58.7853762663,-27.4541071383207],[-58.7854208216926,-27.4540479249996],[-58.7854456634697,-27.4540205409265],[-58.7854962188788,-27.4540198927631],[-58.7855118214515,-27.4540467583076],[-58.7855679410379,-27.4540776152952],[-58.7855979836491,-27.454059186375],[-58.7856228253829,-27.4540318022723],[-58.7856374833617,-27.4540000378115],[-58.7856673079466,-27.4539680788802],[-58.7857174999931,-27.4539448806423],[-58.7857525254108,-27.4539218768672],[-58.7857419056679,-27.4538904365264],[-58.7857413969971,-27.4538588665332],[-58.7857007347376,-27.4538458551363],[-58.7856798586268,-27.4538055244391],[-58.7856890250451,-27.4537467648019],[-58.7857186315532,-27.4537012758648],[-58.7857882462149,-27.4536282083172],[-58.7858228355026,-27.4535781445347]]]}"
76,152,215,367,200,225,6.18,59,"{""type"":""Polygon"",""coordinates"":[[[-58.7821783097203,-27.4630887694503],[-58.7810357147033,-27.4627921356865],[-58.7806652527955,-27.4627111663154],[-58.7799085829495,-27.4625133383724],[-58.7792994069148,-27.4623677526743],[-58.7786799032495,-27.4622087633732],[-58.7785239898735,-27.4628919063511],[-58.7785302766688,-27.462968511953],[-58.7783156442486,-27.4637742000238],[-58.7802344229391,-27.4642233271753],[-58.7805697875174,-27.4643227901002],[-58.7817073415193,-27.4646194916382],[-58.781952141117,-27.4638043912655],[-58.7821783097203,-27.4630887694503]]]}"
77,170,231,401,166,229,4.08,98,"{""type"":""Polygon"",""coordinates"":[[[-58.7844277614655,-27.4636599115461],[-58.7833158543711,-27.4633854582885],[-58.7821783097203,-27.4630887694503],[-58.781952141117,-27.4638043912655],[-58.7817073415193,-27.4646194916382],[-58.7828498845703,-27.4649116088319],[-58.7839570407483,-27.4652041698505],[-58.7842117913435,-27.4643799167347],[-58.7844277614655,-27.4636599115461]]]}"
78,488,500,988,369,502,7.87,126,"{""type"":""Polygon"",""coordinates"":[[[-58.7844277614655,-27.4636599115461],[-58.7842117913435,-27.4643799167347],[-58.7839570407483,-27.4652041698505],[-58.7851553568315,-27.4655045748504],[-58.7857746686761,-27.4656500039598],[-58.7864195532982,-27.465813145812],[-58.7869323994958,-27.4659418920161],[-58.7872677016547,-27.4660368282544],[-58.7880140033322,-27.4662167042441],[-58.7882119188991,-27.466259271485],[-58.7888009744742,-27.4664095863547],[-58.7893745717875,-27.4665420536807],[-58.7899382038846,-27.4666836685474],[-58.7896824393204,-27.4661907556918],[-58.7893093678056,-27.4656361970804],[-58.7890101861867,-27.4655859108321],[-58.7882535570038,-27.4653926399719],[-58.7874410954227,-27.4651865489485],[-58.7868234220431,-27.4642020745315],[-58.7862500575996,-27.4640831258973],[-58.7856508327261,-27.4639284191227],[-58.7844277614655,-27.4636599115461]]]}"
79,406,445,851,258,232,10.61,80,"{""type"":""Polygon"",""coordinates"":[[[-58.7909965659636,-27.462704961175],[-58.7906788447111,-27.4627586678554],[-58.7900434011555,-27.4628660790832],[-58.7891352996686,-27.4629995459712],[-58.7885938451653,-27.4632906906523],[-58.7879818225194,-27.4635962723257],[-58.7886296198169,-27.4645668216773],[-58.7891953664045,-27.4654662472631],[-58.7893093678056,-27.4656361970804],[-58.7896824393204,-27.4661907556918],[-58.7899382038846,-27.4666836685474],[-58.7905170056307,-27.4668250859785],[-58.7908267408336,-27.4669022985775],[-58.7915223459786,-27.4670737856041],[-58.7913969380191,-27.4665115349482],[-58.7917197985245,-27.4664622710635],[-58.791586124933,-27.465701646635],[-58.791387551216,-27.4646802238594],[-58.7911841445043,-27.4636723954652],[-58.7909965659636,-27.462704961175]]]}"
80,274,323,597,241,348,6.06,99,"{""type"":""Polygon"",""coordinates"":[[[-58.8218976467203,-27.4665848607366],[-58.821650717942,-27.4666377115687],[-58.8210557391642,-27.4667447347054],[-58.8207117072314,-27.4667357018079],[-58.8198831120609,-27.4667826228145],[-58.8199109115342,-27.4669356291364],[-58.8200406132729,-27.4677504017134],[-58.8200885468312,-27.4682053732476],[-58.820114329535,-27.46854335164],[-58.8201996579844,-27.4691196276987],[-58.821527936911,-27.4690120364182],[-58.8227798512019,-27.4688738563717],[-58.8225858281863,-27.467532157571],[-58.8219674432234,-27.4671387844868],[-58.8218652097915,-27.4670724593384],[-58.8217930159707,-27.4669876975291],[-58.8217765869113,-27.4669112277031],[-58.8217702699261,-27.4668346255495],[-58.8217795660588,-27.4667848843147],[-58.8217940665531,-27.4667440967188],[-58.8218135488804,-27.4666987330575],[-58.8218480508869,-27.4666441510998],[-58.8218728117215,-27.4666122509697],[-58.8218976467203,-27.4665848607366]]]}"
81,361,398,759,255,257,12.36,61,"{""type"":""Polygon"",""coordinates"":[[[-58.8198831120609,-27.4667826228145],[-58.8194130496203,-27.4667977885174],[-58.8183469674352,-27.4668568256349],[-58.8181261304519,-27.4669589491398],[-58.8174816211736,-27.4671297562894],[-58.8168257400649,-27.4672240239912],[-58.8160438258119,-27.4673424871655],[-58.8162140227236,-27.4681612468739],[-58.8162404864735,-27.468233075679],[-58.8163614833115,-27.4688269329953],[-58.8164279259954,-27.4691779145539],[-58.8164542422347,-27.4692407234643],[-58.8165924814012,-27.4699606599986],[-58.8167238908988,-27.4705724243571],[-58.8167497637938,-27.4706081737088],[-58.81846672689,-27.4704549398732],[-58.8184445027524,-27.4703334365829],[-58.8184473374623,-27.4701980733214],[-58.8184809535609,-27.4700893732057],[-58.818534794307,-27.469980408879],[-58.8187184661117,-27.4697705091432],[-58.8189231765884,-27.4696099539054],[-58.8193916396012,-27.4691888317237],[-58.8201996579844,-27.4691196276987],[-58.820114329535,-27.46854335164],[-58.8200885468312,-27.4682053732476],[-58.8200406132729,-27.4677504017134],[-58.8199109115342,-27.4669356291364],[-58.8198831120609,-27.4667826228145]]]}"
82,404,569,973,411,510,12.97,75,"{""type"":""Polygon"",""coordinates"":[[[-58.8227798512019,-27.4688738563717],[-58.821527936911,-27.4690120364182],[-58.8201996579844,-27.4691196276987],[-58.8193916396012,-27.4691888317237],[-58.8189231765884,-27.4696099539054],[-58.8187184661117,-27.4697705091432],[-58.818534794307,-27.469980408879],[-58.8184809535609,-27.4700893732057],[-58.8184473374623,-27.4701980733214],[-58.8184445027524,-27.4703334365829],[-58.81846672689,-27.4704549398732],[-58.8167497637938,-27.4706081737088],[-58.8169910311622,-27.4717507872404],[-58.8182835084363,-27.471616627832],[-58.8186865272934,-27.4715211454557],[-58.8192334908643,-27.4715681287163],[-58.8205106450432,-27.4714251272871],[-58.8218180583899,-27.4712772073563],[-58.8230701460841,-27.4711480433035],[-58.8229303870054,-27.4700311783949],[-58.8227798512019,-27.4688738563717]]]}"
83,446,555,1001,319,341,20.58,49,"{""type"":""Polygon"",""coordinates"":[[[-58.8160438258119,-27.4673424871655],[-58.8143935949112,-27.4675534613121],[-58.8139896995142,-27.4675948117457],[-58.8130074907761,-27.4675264106396],[-58.8118327829234,-27.4674379535446],[-58.8121321911534,-27.4687377022627],[-58.8122799974172,-27.469425943424],[-58.8121894291229,-27.4694541877506],[-58.8126975934646,-27.4711481744375],[-58.8126833105361,-27.4712024910142],[-58.8129410716535,-27.4721193540808],[-58.8130073940949,-27.4721545773313],[-58.814360484628,-27.4720151537175],[-58.8156833072761,-27.4718806227363],[-58.8169910311622,-27.4717507872404],[-58.8167497637938,-27.4706081737088],[-58.8167238908988,-27.4705724243571],[-58.8165924814012,-27.4699606599986],[-58.8164542422347,-27.4692407234643],[-58.8164279259954,-27.4691779145539],[-58.8163614833115,-27.4688269329953],[-58.8162404864735,-27.468233075679],[-58.8162140227236,-27.4681612468739],[-58.8160438258119,-27.4673424871655]]]}"
84,304,319,623,179,204,7.03,89,"{""type"":""Polygon"",""coordinates"":[[[-58.8109969073332,-27.4673495900581],[-58.810753846937,-27.467330197261],[-58.8102168707291,-27.4672740281068],[-58.810171719841,-27.4679151612697],[-58.8104322220059,-27.4686921572492],[-58.8107673487813,-27.4697027479371],[-58.8109871890222,-27.4704667386639],[-58.8112980784835,-27.4715407951666],[-58.8115750666147,-27.4714695274691],[-58.8120283593345,-27.4713553664044],[-58.8126833105361,-27.4712024910142],[-58.8126975934646,-27.4711481744375],[-58.8121894291229,-27.4694541877506],[-58.8122799974172,-27.469425943424],[-58.8121321911534,-27.4687377022627],[-58.8118327829234,-27.4674379535446],[-58.8109969073332,-27.4673495900581]]]}"
85,537,567,1104,299,310,63.23,17,"{""type"":""Polygon"",""coordinates"":[[[-58.8088243868442,-27.4671658225063],[-58.8082375874583,-27.4671554018878],[-58.8076306373201,-27.4671497513244],[-58.8071117742069,-27.4672737706056],[-58.8065928362646,-27.4673932780674],[-58.8062207445903,-27.4675244111726],[-58.8060797621029,-27.46756232739],[-58.8050429820684,-27.4678689820941],[-58.8042630302315,-27.4681091483644],[-58.8041372146216,-27.4681468660902],[-58.8037698795203,-27.4682598875859],[-58.8028487899548,-27.4685289401308],[-58.8025619836695,-27.4686183611306],[-58.8017565194685,-27.4688453113354],[-58.8013488032054,-27.4689633601222],[-58.8003210811233,-27.4692067106608],[-58.8000474603263,-27.4691741617397],[-58.7996974838122,-27.4691110230963],[-58.7993982893357,-27.4690607598824],[-58.7990915428102,-27.4701022320503],[-58.7990100555188,-27.4703784501946],[-58.7991802070071,-27.4712017461993],[-58.7992893194997,-27.4716920241375],[-58.7994287711664,-27.4724931618738],[-58.7995205186478,-27.4728483369422],[-58.7997185995123,-27.4738336630586],[-58.7998727873775,-27.4746075439964],[-58.8001846736151,-27.4745042709396],[-58.8007832354602,-27.4743025598407],[-58.8013817949903,-27.474100846266],[-58.8020863898554,-27.4738887356456],[-58.8026902945445,-27.4737049909677],[-58.8034244143778,-27.4734428715232],[-58.8052932709116,-27.472985600484],[-58.8063005683849,-27.4727289448297],[-58.8072174357751,-27.4725095432265],[-58.8083007156026,-27.4722609086593],[-58.809489656451,-27.4719793161482],[-58.8112980784835,-27.4715407951666],[-58.8109871890222,-27.4704667386639],[-58.8107673487813,-27.4697027479371],[-58.8104322220059,-27.4686921572492],[-58.810171719841,-27.4679151612697],[-58.8102168707291,-27.4672740281068],[-58.8097863672753,-27.4672345163346],[-58.8094167579698,-27.4672077444526],[-58.8088243868442,-27.4671658225063]]]}"
86,605,656,1261,331,361,17.31,73,"{""type"":""Polygon"",""coordinates"":[[[-58.8026902945445,-27.4737049909677],[-58.8020863898554,-27.4738887356456],[-58.8013817949903,-27.474100846266],[-58.8007832354602,-27.4743025598407],[-58.8001846736151,-27.4745042709396],[-58.7998727873775,-27.4746075439964],[-58.7995151726303,-27.4746978748746],[-58.7996108074257,-27.4752920770775],[-58.7997054904855,-27.4758276497639],[-58.7997799485316,-27.476363483842],[-58.799864447229,-27.4768946770802],[-58.7999438170012,-27.4774214256337],[-58.8000483973148,-27.4779433371338],[-58.8001328989551,-27.4784745299745],[-58.8002072882771,-27.4790058534982],[-58.8003117984298,-27.4795232546093],[-58.8010587904012,-27.4794278828755],[-58.8010295452069,-27.4791846730461],[-58.801471814708,-27.4790120460494],[-58.8015777105193,-27.4789926317495],[-58.8025635238578,-27.4786550831828],[-58.8034437299421,-27.4783549834161],[-58.8033474099631,-27.4777201957533],[-58.8032015426696,-27.4768379507708],[-58.8029766622936,-27.475451508907],[-58.8026902945445,-27.4737049909677]]]}"
87,323,364,687,203,193,9.48,72,"{""type"":""Polygon"",""coordinates"":[[[-58.8052932709116,-27.472985600484],[-58.8034244143778,-27.4734428715232],[-58.8026902945445,-27.4737049909677],[-58.8029766622936,-27.475451508907],[-58.8032015426696,-27.4768379507708],[-58.8039474110368,-27.4766749153896],[-58.8039656531756,-27.4765528848847],[-58.8047872923813,-27.4763843521354],[-58.8048687111129,-27.4764148726099],[-58.805014761688,-27.4763768915277],[-58.8058161716435,-27.476208615133],[-58.8057262211062,-27.4756549427314],[-58.8056514409733,-27.4751010734025],[-58.8054613587437,-27.4739893491436],[-58.8052932709116,-27.472985600484]]]}"
88,467,549,1016,286,274,11.3,90,"{""type"":""Polygon"",""coordinates"":[[[-58.8083007156026,-27.4722609086593],[-58.8072174357751,-27.4725095432265],[-58.8063005683849,-27.4727289448297],[-58.8052932709116,-27.472985600484],[-58.8054613587437,-27.4739893491436],[-58.8056514409733,-27.4751010734025],[-58.8057262211062,-27.4756549427314],[-58.8058161716435,-27.476208615133],[-58.8069145132328,-27.4759507729127],[-58.8079474096975,-27.4757118158283],[-58.8079396286039,-27.4755450141016],[-58.8090086505973,-27.4753506889408],[-58.8088780864338,-27.4747885251161],[-58.8087631349624,-27.4742532235172],[-58.8086281802351,-27.4737317143201],[-58.8085238596536,-27.4732278504465],[-58.8083818627797,-27.472584638389],[-58.8083007156026,-27.4722609086593]]]}"
89,460,571,1031,244,262,12.02,86,"{""type"":""Polygon"",""coordinates"":[[[-58.8115750666147,-27.4714695274691],[-58.8112980784835,-27.4715407951666],[-58.809489656451,-27.4719793161482],[-58.8083007156026,-27.4722609086593],[-58.8083818627797,-27.472584638389],[-58.8085238596536,-27.4732278504465],[-58.8086281802351,-27.4737317143201],[-58.8087631349624,-27.4742532235172],[-58.8088780864338,-27.4747885251161],[-58.8090086505973,-27.4753506889408],[-58.8104094759799,-27.4750347574353],[-58.8113418905307,-27.4748376805023],[-58.812410676754,-27.4746298000409],[-58.8122643369578,-27.4740317582857],[-58.8121301042984,-27.4735553524611],[-58.8119587074991,-27.4729711690444],[-58.8118611262762,-27.472570970708],[-58.8118650757608,-27.4725032560616],[-58.8117900816577,-27.4722471118754],[-58.8115750666147,-27.4714695274691]]]}"
90,522,537,1059,315,299,10.88,97,"{""type"":""Polygon"",""coordinates"":[[[-58.8126833105361,-27.4712024910142],[-58.8120283593345,-27.4713553664044],[-58.8115750666147,-27.4714695274691],[-58.8117900816577,-27.4722471118754],[-58.8118650757608,-27.4725032560616],[-58.8118611262762,-27.472570970708],[-58.8119587074991,-27.4729711690444],[-58.8121301042984,-27.4735553524611],[-58.8122643369578,-27.4740317582857],[-58.812410676754,-27.4746298000409],[-58.8135900343634,-27.4743798729545],[-58.814857561944,-27.4742641127938],[-58.8161651673243,-27.4741252638691],[-58.8160448296631,-27.4735719962398],[-58.8159346799685,-27.4730231063908],[-58.8156833072761,-27.4718806227363],[-58.814360484628,-27.4720151537175],[-58.8130073940949,-27.4721545773313],[-58.8129410716535,-27.4721193540808],[-58.8126833105361,-27.4712024910142]]]}"
91,631,730,1361,454,513,18.25,75,"{""type"":""Polygon"",""coordinates"":[[[-58.8230701460841,-27.4711480433035],[-58.8218180583899,-27.4712772073563],[-58.8205106450432,-27.4714251272871],[-58.8192334908643,-27.4715681287163],[-58.8186865272934,-27.4715211454557],[-58.8182835084363,-27.471616627832],[-58.8169910311622,-27.4717507872404],[-58.8156833072761,-27.4718806227363],[-58.8159346799685,-27.4730231063908],[-58.8160448296631,-27.4735719962398],[-58.8161651673243,-27.4741252638691],[-58.8167862871015,-27.474067538613],[-58.8175084593156,-27.4740039802827],[-58.819118919352,-27.4738295728817],[-58.8196441127664,-27.473782110331],[-58.8196643381552,-27.4737818459289],[-58.8207598595307,-27.4736637700407],[-58.8220372575142,-27.4735342832499],[-58.8233452867539,-27.4734224270461],[-58.8232050751439,-27.4722785036721],[-58.8230701460841,-27.4711480433035]]]}"
92,492,630,1122,348,337,14.77,76,"{""type"":""Polygon"",""coordinates"":[[[-58.8135900343634,-27.4743798729545],[-58.812410676754,-27.4746298000409],[-58.8113418905307,-27.4748376805023],[-58.8104094759799,-27.4750347574353],[-58.810569944462,-27.4755694652296],[-58.8107056485171,-27.4761360710891],[-58.8108475908006,-27.4767747696691],[-58.8109947390118,-27.4774224220177],[-58.811126350586,-27.47804772187],[-58.8113069411148,-27.4788843954224],[-58.8123820038953,-27.4787486062737],[-58.8134876246746,-27.4786259433644],[-58.814688873902,-27.478474959669],[-58.814544806947,-27.4780167287345],[-58.8142310562626,-27.476771306132],[-58.8139062401104,-27.475467385164],[-58.8135900343634,-27.4743798729545]]]}"
93,453,480,933,250,236,9.25,101,"{""type"":""Polygon"",""coordinates"":[[[-58.8104094759799,-27.4750347574353],[-58.8090086505973,-27.4753506889408],[-58.8079396286039,-27.4755450141016],[-58.8079474096975,-27.4757118158283],[-58.8069145132328,-27.4759507729127],[-58.8058161716435,-27.476208615133],[-58.8060000289872,-27.4772482448889],[-58.8071184591281,-27.4769811183069],[-58.807324765259,-27.4781557808293],[-58.8079204107157,-27.4780848923945],[-58.8084605803023,-27.4780237440471],[-58.808323779811,-27.4773894867838],[-58.8094017523893,-27.4771228676176],[-58.8108475908006,-27.4767747696691],[-58.8107056485171,-27.4761360710891],[-58.810569944462,-27.4755694652296],[-58.8104094759799,-27.4750347574353]]]}"
94,325,406,731,207,202,10.32,71,"{""type"":""Polygon"",""coordinates"":[[[-58.8108475908006,-27.4767747696691],[-58.8094017523893,-27.4771228676176],[-58.808323779811,-27.4773894867838],[-58.8084605803023,-27.4780237440471],[-58.8079204107157,-27.4780848923945],[-58.807324765259,-27.4781557808293],[-58.8071184591281,-27.4769811183069],[-58.8060000289872,-27.4772482448889],[-58.8060807523598,-27.4778561672952],[-58.8061692356134,-27.4783196404787],[-58.8063278177583,-27.4793595972858],[-58.8063403593493,-27.479508293765],[-58.8075415579455,-27.4793528609435],[-58.8087684040939,-27.4792196389537],[-58.8098028740272,-27.4790753753166],[-58.8113069411148,-27.4788843954224],[-58.811126350586,-27.47804772187],[-58.8109947390118,-27.4774224220177],[-58.8108475908006,-27.4767747696691]]]}"
95,327,369,696,199,171,15.27,46,"{""type"":""Polygon"",""coordinates"":[[[-58.8058161716435,-27.476208615133],[-58.805014761688,-27.4763768915277],[-58.8048687111129,-27.4764148726099],[-58.8047872923813,-27.4763843521354],[-58.8039656531756,-27.4765528848847],[-58.8039474110368,-27.4766749153896],[-58.8032015426696,-27.4768379507708],[-58.8033474099631,-27.4777201957533],[-58.8034437299421,-27.4783549834161],[-58.8025635238578,-27.4786550831828],[-58.8015777105193,-27.4789926317495],[-58.801471814708,-27.4790120460494],[-58.8010295452069,-27.4791846730461],[-58.8010587904012,-27.4794278828755],[-58.8003117984298,-27.4795232546093],[-58.8003862629588,-27.4800590878321],[-58.8004604349655,-27.4805768811598],[-58.8005116668146,-27.4809280681038],[-58.8012418833956,-27.4807336724593],[-58.8015036583364,-27.4806581098802],[-58.8021581674257,-27.4804737112903],[-58.8030138400259,-27.4802190403599],[-58.8033510952813,-27.48011994205],[-58.8037084296357,-27.480011560936],[-58.804443469773,-27.4798035536786],[-58.8053914747325,-27.4796288672936],[-58.8063403593493,-27.479508293765],[-58.8063278177583,-27.4793595972858],[-58.8061692356134,-27.4783196404787],[-58.8060807523598,-27.4778561672952],[-58.8060000289872,-27.4772482448889],[-58.8058161716435,-27.476208615133]]]}"
96,386,417,803,233,230,10.4,77,"{""type"":""Polygon"",""coordinates"":[[[-58.814688873902,-27.478474959669],[-58.8134876246746,-27.4786259433644],[-58.8123820038953,-27.4787486062737],[-58.812694264069,-27.4799038351414],[-58.8122358810374,-27.4800180657472],[-58.8123541793424,-27.4807563091576],[-58.81246066774,-27.4813909559884],[-58.8126288374508,-27.4823946910808],[-58.8139761834029,-27.4822057221596],[-58.8152983882179,-27.4820260900252],[-58.8153957975175,-27.4821060150702],[-58.8153222202649,-27.4816288224057],[-58.8152157152757,-27.4809941785914],[-58.8151389318363,-27.4806297993549],[-58.8150993202389,-27.4803731962078],[-58.8150420988395,-27.4799679638672],[-58.8149815958292,-27.4796710352372],[-58.8149007927934,-27.4793698604054],[-58.814861995618,-27.4791628661114],[-58.814688873902,-27.478474959669]]]}"
97,423,476,899,241,206,9.35,96,"{""type"":""Polygon"",""coordinates"":[[[-58.8123820038953,-27.4787486062737],[-58.8113069411148,-27.4788843954224],[-58.8098028740272,-27.4790753753166],[-58.809971205194,-27.4797813946564],[-58.8101499471049,-27.4805053217659],[-58.8102958344358,-27.4816942964671],[-58.8104238998629,-27.4827211109422],[-58.8112968778317,-27.4825969794718],[-58.8126288374508,-27.4823946910808],[-58.81246066774,-27.4813909559884],[-58.8123541793424,-27.4807563091576],[-58.8122358810374,-27.4800180657472],[-58.812694264069,-27.4799038351414],[-58.8123820038953,-27.4787486062737]]]}"
98,512,580,1092,317,285,14.7,74,"{""type"":""Polygon"",""coordinates"":[[[-58.8098028740272,-27.4790753753166],[-58.8087684040939,-27.4792196389537],[-58.8075415579455,-27.4793528609435],[-58.8063403593493,-27.479508293765],[-58.806451868573,-27.4801428813945],[-58.8065134531879,-27.4805074637624],[-58.8066437414689,-27.4813628406842],[-58.8067392236599,-27.4822547562704],[-58.8068472508289,-27.4832953679114],[-58.8080781670719,-27.4830989453222],[-58.8093190444553,-27.4828933607124],[-58.8104238998629,-27.4827211109422],[-58.8102958344358,-27.4816942964671],[-58.8101499471049,-27.4805053217659],[-58.809971205194,-27.4797813946564],[-58.8098028740272,-27.4790753753166]]]}"
99,720,785,1505,382,380,17.85,84,"{""type"":""Polygon"",""coordinates"":[[[-58.8063403593493,-27.479508293765],[-58.8053914747325,-27.4796288672936],[-58.804443469773,-27.4798035536786],[-58.8037084296357,-27.480011560936],[-58.8033510952813,-27.48011994205],[-58.8030138400259,-27.4802190403599],[-58.8021581674257,-27.4804737112903],[-58.8022725177531,-27.481284190972],[-58.8024666872854,-27.4823372247148],[-58.8021542678821,-27.4824089341565],[-58.8022480901631,-27.4828903844349],[-58.8024418225641,-27.4839163582272],[-58.8033198787217,-27.4837922104576],[-58.8045764604112,-27.4836180403244],[-58.8057675194438,-27.4834582418582],[-58.8068472508289,-27.4832953679114],[-58.8067392236599,-27.4822547562704],[-58.8066437414689,-27.4813628406842],[-58.8065134531879,-27.4805074637624],[-58.806451868573,-27.4801428813945],[-58.8063403593493,-27.479508293765]]]}"
100,610,692,1302,348,331,22.37,58,"{""type"":""Polygon"",""coordinates"":[[[-58.8021581674257,-27.4804737112903],[-58.8015036583364,-27.4806581098802],[-58.8012418833956,-27.4807336724593],[-58.8005116668146,-27.4809280681038],[-58.7993135898027,-27.4812773692405],[-58.798337416213,-27.4815877058667],[-58.7975320687892,-27.4818281660148],[-58.7967113276423,-27.4820552876565],[-58.7956490268992,-27.4823576959889],[-58.7952463109427,-27.4824756641266],[-58.7946825070557,-27.4826408176265],[-58.7938821266334,-27.4828766821826],[-58.7940509625487,-27.4833075523082],[-58.7940914043476,-27.4836182831516],[-58.7955344488866,-27.4834011922136],[-58.7962811797507,-27.483287804916],[-58.7963349618907,-27.4837968422184],[-58.7963778989329,-27.4842609104673],[-58.7964519099137,-27.4847696864945],[-58.7971581202124,-27.4846523064088],[-58.7977535165276,-27.4845634197793],[-58.7983438548417,-27.4844745959961],[-58.7988489578964,-27.4844319805048],[-58.7996963888907,-27.4842902076508],[-58.8008418794473,-27.4841265293251],[-58.8016745747057,-27.4840120006095],[-58.8024418225641,-27.4839163582272],[-58.8022480901631,-27.4828903844349],[-58.8021542678821,-27.4824089341565],[-58.8024666872854,-27.4823372247148],[-58.8022725177531,-27.481284190972],[-58.8021581674257,-27.4804737112903]]]}"
101,1099,1127,2226,581,562,53.39,42,"{""type"":""Polygon"",""coordinates"":[[[-58.7938821266334,-27.4828766821826],[-58.7936657058533,-27.4829426243926],[-58.7924925744015,-27.4832735030241],[-58.7911582722147,-27.4836470446592],[-58.7896993132974,-27.4838191861601],[-58.7882495155261,-27.4839325529532],[-58.7871728327108,-27.4839734498356],[-58.7867789038314,-27.484010084677],[-58.7859605580833,-27.4840747204909],[-58.7853284440577,-27.4840828314657],[-58.7853957824683,-27.4848082246114],[-58.785503904845,-27.4858669018624],[-58.7856115205425,-27.486894008932],[-58.7856887235083,-27.4879169950915],[-58.7857858658908,-27.4889216814798],[-58.7858215943697,-27.4892550302826],[-58.785891267589,-27.4894977251827],[-58.786034871514,-27.4899334401714],[-58.786312215486,-27.4898802598695],[-58.7865138471954,-27.4898370729728],[-58.7867306502417,-27.4897936909729],[-58.7869625517735,-27.489745603827],[-58.7871088454513,-27.4897211703964],[-58.7873913182605,-27.4896724330097],[-58.787855411348,-27.48959429607],[-58.788299493723,-27.4895299475067],[-58.7887333882998,-27.4894612176047],[-58.78914683493,-27.4893792165789],[-58.789615982348,-27.4893010088527],[-58.7916961094341,-27.488750974722],[-58.7925270987491,-27.4885282596775],[-58.7932481440329,-27.4883881529224],[-58.7938784522617,-27.488267255898],[-58.7953472817661,-27.4880768978616],[-58.7951991913015,-27.4870548347551],[-58.7951419642092,-27.4866450813055],[-58.7950963877222,-27.4863299063714],[-58.7941822422512,-27.4864138704057],[-58.794348842446,-27.4860824265502],[-58.7942670533992,-27.4860293503749],[-58.7941962073116,-27.4854032487305],[-58.7941685956459,-27.4849480037829],[-58.7941424464075,-27.484582957959],[-58.7941159319023,-27.4841953623103],[-58.7941166757798,-27.4839292095458],[-58.7940914043476,-27.4836182831516],[-58.7940509625487,-27.4833075523082],[-58.7938821266334,-27.4828766821826]]]}"
102,496,524,1020,268,295,14.53,70,"{""type"":""Polygon"",""coordinates"":[[[-58.7853284440577,-27.4840828314657],[-58.7837255470601,-27.484112408007],[-58.7833139746913,-27.4839958880684],[-58.7829466076869,-27.4837976040146],[-58.7830099059263,-27.4839591860391],[-58.7830130298561,-27.4841531154461],[-58.7829746086301,-27.4842799133928],[-58.7828314445604,-27.4844982716108],[-58.7826215953345,-27.4846588420217],[-58.7823309794615,-27.4848294684443],[-58.7819591865337,-27.4852988543866],[-58.781806195642,-27.4855353811433],[-58.7817667561755,-27.4855990389856],[-58.7813701330711,-27.4864115711818],[-58.7807526352978,-27.4879576978824],[-58.7811534529204,-27.4880337643379],[-58.7813053838473,-27.4880453522227],[-58.7817548852725,-27.4880035098531],[-58.782183867364,-27.4879438851873],[-58.7826481759298,-27.4878792957294],[-58.7835467393806,-27.4877685410897],[-58.7840109007456,-27.4876949271906],[-58.7844547603748,-27.4876170612014],[-58.7843315796724,-27.4868788510424],[-58.7846764040465,-27.486933070822],[-58.7849349679637,-27.4869703526001],[-58.7856115205425,-27.486894008932],[-58.785503904845,-27.4858669018624],[-58.7853957824683,-27.4848082246114],[-58.7853284440577,-27.4840828314657]]]}"
103,472,528,1000,259,245,11.58,86,"{""type"":""Polygon"",""coordinates"":[[[-58.7856115205425,-27.486894008932],[-58.7849349679637,-27.4869703526001],[-58.7846764040465,-27.486933070822],[-58.7843315796724,-27.4868788510424],[-58.7844547603748,-27.4876170612014],[-58.7840109007456,-27.4876949271906],[-58.7835467393806,-27.4877685410897],[-58.7826481759298,-27.4878792957294],[-58.782183867364,-27.4879438851873],[-58.7817548852725,-27.4880035098531],[-58.7813053838473,-27.4880453522227],[-58.7811534529204,-27.4880337643379],[-58.7807526352978,-27.4879576978824],[-58.7805869342342,-27.4883477573036],[-58.7797036535122,-27.4903528834019],[-58.780674661496,-27.4906562242598],[-58.7808778941175,-27.490712265087],[-58.7810691251019,-27.490651175426],[-58.781154009013,-27.490582425093],[-58.781008874869,-27.4897362306514],[-58.7815437745018,-27.4896572082883],[-58.782013220501,-27.4895970658403],[-58.7829066688552,-27.4894818694526],[-58.783366144136,-27.4894308720708],[-58.7838155772839,-27.4893845128376],[-58.7842493294867,-27.4893067768579],[-58.7847234654672,-27.4892240106568],[-58.7852309635028,-27.4890145093203],[-58.7857858658908,-27.4889216814798],[-58.7856887235083,-27.4879169950915],[-58.7856115205425,-27.486894008932]]]}"
104,667,711,1378,336,342,13.58,101,"{""type"":""Polygon"",""coordinates"":[[[-58.7857858658908,-27.4889216814798],[-58.7852309635028,-27.4890145093203],[-58.7847234654672,-27.4892240106568],[-58.7842493294867,-27.4893067768579],[-58.7838155772839,-27.4893845128376],[-58.783366144136,-27.4894308720708],[-58.7829066688552,-27.4894818694526],[-58.782013220501,-27.4895970658403],[-58.7815437745018,-27.4896572082883],[-58.781008874869,-27.4897362306514],[-58.781154009013,-27.490582425093],[-58.7812218828092,-27.4910281368535],[-58.7812839013733,-27.4914243034308],[-58.7813660043625,-27.4918111909725],[-58.7814783065475,-27.4921886699277],[-58.7824324638737,-27.4920726985484],[-58.7828463619463,-27.4920177754855],[-58.783295515117,-27.4919533775168],[-58.7837649694815,-27.4918932287569],[-58.7842042250647,-27.4918424875094],[-58.784638131937,-27.4917737698526],[-58.7851124962886,-27.4917045317929],[-58.7863041166693,-27.4915719545171],[-58.7862217055991,-27.4911670307965],[-58.7861749869274,-27.4907796924258],[-58.786034871514,-27.4899334401714],[-58.785891267589,-27.4894977251827],[-58.7858215943697,-27.4892550302826],[-58.7857858658908,-27.4889216814798]]]}"
105,519,533,1052,260,278,8.82,119,"{""type"":""Polygon"",""coordinates"":[[[-58.7940914043476,-27.4836182831516],[-58.7941166757798,-27.4839292095458],[-58.7941159319023,-27.4841953623103],[-58.7941424464075,-27.484582957959],[-58.7941685956459,-27.4849480037829],[-58.7941962073116,-27.4854032487305],[-58.7942670533992,-27.4860293503749],[-58.794348842446,-27.4860824265502],[-58.7941822422512,-27.4864138704057],[-58.7950963877222,-27.4863299063714],[-58.7951419642092,-27.4866450813055],[-58.7951991913015,-27.4870548347551],[-58.7953472817661,-27.4880768978616],[-58.7959781708943,-27.4879920711269],[-58.7958050824404,-27.4869883750831],[-58.7963351175094,-27.486922892062],[-58.7965079458027,-27.486352287928],[-58.7965500911126,-27.4861442425721],[-58.7965336814137,-27.4857565173131],[-58.7964847341977,-27.4852338851727],[-58.7964519099137,-27.4847696864945],[-58.7963778989329,-27.4842609104673],[-58.7963349618907,-27.4837968422184],[-58.7962811797507,-27.483287804916],[-58.7955344488866,-27.4834011922136],[-58.7940914043476,-27.4836182831516]]]}"
106,357,386,743,198,213,9.23,80,"{""type"":""Polygon"",""coordinates"":[[[-58.7965336814137,-27.4857565173131],[-58.7965500911126,-27.4861442425721],[-58.7965079458027,-27.486352287928],[-58.7963351175094,-27.486922892062],[-58.7958050824404,-27.4869883750831],[-58.7959781708943,-27.4879920711269],[-58.7964829985155,-27.487931423632],[-58.7969879719362,-27.4878797942292],[-58.797664151907,-27.4877808423359],[-58.7982394827648,-27.4877012340973],[-58.799415646723,-27.4875552134514],[-58.8002637607314,-27.4874540255643],[-58.8000896812678,-27.4863917073524],[-58.7998997748884,-27.4852889953413],[-58.7990218484233,-27.4854221421418],[-58.7984820752375,-27.4855103154438],[-58.7978919513746,-27.4856126699061],[-58.7977153244401,-27.4856375063],[-58.7973567203848,-27.4856692039441],[-58.7965336814137,-27.4857565173131]]]}"
107,652,708,1360,344,316,13.45,101,"{""type"":""Polygon"",""coordinates"":[[[-58.8024418225641,-27.4839163582272],[-58.8016745747057,-27.4840120006095],[-58.8008418794473,-27.4841265293251],[-58.7996963888907,-27.4842902076508],[-58.7988489578964,-27.4844319805048],[-58.7983438548417,-27.4844745959961],[-58.7977535165276,-27.4845634197793],[-58.7971581202124,-27.4846523064088],[-58.7964519099137,-27.4847696864945],[-58.7964847341977,-27.4852338851727],[-58.7965336814137,-27.4857565173131],[-58.7973567203848,-27.4856692039441],[-58.7977153244401,-27.4856375063],[-58.7978919513746,-27.4856126699061],[-58.7984820752375,-27.4855103154438],[-58.7990218484233,-27.4854221421418],[-58.7998997748884,-27.4852889953413],[-58.8000896812678,-27.4863917073524],[-58.8002637607314,-27.4874540255643],[-58.8013894216245,-27.4873131526658],[-58.8022474249479,-27.4871982921105],[-58.802631022968,-27.4871482143945],[-58.8029793685094,-27.4871076141798],[-58.8027942684726,-27.4859913123419],[-58.8026102011438,-27.4849381490284],[-58.8024418225641,-27.4839163582272]]]}"
108,610,613,1223,349,330,15.5,79,"{""type"":""Polygon"",""coordinates"":[[[-58.8068472508289,-27.4832953679114],[-58.8057675194438,-27.4834582418582],[-58.8045764604112,-27.4836180403244],[-58.8033198787217,-27.4837922104576],[-58.8024418225641,-27.4839163582272],[-58.8026102011438,-27.4849381490284],[-58.8027942684726,-27.4859913123419],[-58.8029793685094,-27.4871076141798],[-58.8038725464456,-27.4869787552811],[-58.8047254131628,-27.4868594353078],[-58.8051442602423,-27.4867998717958],[-58.8057650915808,-27.4867196424959],[-58.8063349841005,-27.4866175172932],[-58.8066984233429,-27.4865722010454],[-58.8072990976641,-27.4864967375666],[-58.8071314092425,-27.4855200541135],[-58.8070401900558,-27.484889715204],[-58.8069494138739,-27.484286435691],[-58.8068472508289,-27.4832953679114]]]}"
109,710,743,1453,366,335,15.52,94,"{""type"":""Polygon"",""coordinates"":[[[-58.8104238998629,-27.4827211109422],[-58.8093190444553,-27.4828933607124],[-58.8080781670719,-27.4830989453222],[-58.8068472508289,-27.4832953679114],[-58.8069494138739,-27.484286435691],[-58.8070401900558,-27.484889715204],[-58.8071314092425,-27.4855200541135],[-58.8072990976641,-27.4864967375666],[-58.8074867944962,-27.4865303866822],[-58.80828852093,-27.4866868730134],[-58.8087097970426,-27.4867761262808],[-58.8099476803167,-27.4870036178544],[-58.8110534960099,-27.4871967301653],[-58.8109210980649,-27.4862150823962],[-58.810737583492,-27.4848912728058],[-58.8105719004648,-27.4837296221995],[-58.8104238998629,-27.4827211109422]]]}"
110,567,636,1203,284,234,11.8,102,"{""type"":""Polygon"",""coordinates"":[[[-58.8126288374508,-27.4823946910808],[-58.8112968778317,-27.4825969794718],[-58.8104238998629,-27.4827211109422],[-58.8105719004648,-27.4837296221995],[-58.810737583492,-27.4848912728058],[-58.8109210980649,-27.4862150823962],[-58.8110534960099,-27.4871967301653],[-58.8120852680578,-27.487192319363],[-58.8124137502038,-27.4871745086565],[-58.8134592143168,-27.4870796918884],[-58.8132420424013,-27.4858645864438],[-58.8131466179186,-27.4852884380838],[-58.8130285293044,-27.484563726028],[-58.8128122550318,-27.4834027379788],[-58.8126288374508,-27.4823946910808]]]}"
111,583,643,1226,331,280,14.63,84,"{""type"":""Polygon"",""coordinates"":[[[-58.8153957975175,-27.4821060150702],[-58.8152983882179,-27.4820260900252],[-58.8139761834029,-27.4822057221596],[-58.8126288374508,-27.4823946910808],[-58.8128122550318,-27.4834027379788],[-58.8130285293044,-27.484563726028],[-58.8131466179186,-27.4852884380838],[-58.8132420424013,-27.4858645864438],[-58.8134592143168,-27.4870796918884],[-58.814403684745,-27.4869952059754],[-58.8148127812003,-27.4869582949807],[-58.8162376597434,-27.4868675303002],[-58.8161521599802,-27.4865889724269],[-58.8160899472301,-27.4861883171067],[-58.8159997865445,-27.4856256351734],[-58.8159942856588,-27.4855986417474],[-58.8159822479372,-27.4854815162468],[-58.8159594305149,-27.4853239335941],[-58.8159307423614,-27.4851168079804],[-58.8157431237913,-27.4841629517829],[-58.8155728511536,-27.4830329448277],[-58.8153957975175,-27.4821060150702]]]}"
112,752,796,1548,340,308,51.15,30,"{""type"":""Polygon"",""coordinates"":[[[-58.854610348742,-27.4912511028231],[-58.8537016668452,-27.491357939395],[-58.8528883117832,-27.4914183924905],[-58.8514586728416,-27.4915276405421],[-58.8507325670721,-27.4916636038884],[-58.849057385242,-27.4919114179447],[-58.8477014702389,-27.4921955698254],[-58.8472122858618,-27.4922832602732],[-58.8466322982584,-27.4923856867247],[-58.8462641067162,-27.4924492138242],[-58.8457398207961,-27.4925554082516],[-58.8458611433453,-27.4934604737596],[-58.845975680437,-27.4942618801513],[-58.8460951262779,-27.4950541995291],[-58.8470888429426,-27.494887641788],[-58.8471953216817,-27.4955087209337],[-58.8472284514279,-27.495675181296],[-58.8473580982518,-27.4964718744307],[-58.8474927293145,-27.4972639902858],[-58.8476324953525,-27.4980605484747],[-58.8465374532151,-27.4982194344236],[-58.8466944321103,-27.49883533251],[-58.8468576751907,-27.4995233201965],[-58.8469598783582,-27.4995851146623],[-58.847141494619,-27.4995556382528],[-58.8474631374026,-27.4994295748647],[-58.8478185142406,-27.4995060493135],[-58.848157362834,-27.4995015477771],[-58.8486434800785,-27.4995311748715],[-58.8488752931487,-27.4994784750488],[-58.8490583473422,-27.4992324580272],[-58.8495465850695,-27.4987839077004],[-58.8498739587519,-27.4986983600095],[-58.8504139715932,-27.4983212912786],[-58.8508826494221,-27.497913594025],[-58.8515636566009,-27.4974985585677],[-58.8519813759483,-27.497068982028],[-58.852899541577,-27.4969214314385],[-58.8536455937025,-27.4961626984571],[-58.8540042755592,-27.4958331406233],[-58.8539191965681,-27.4952839558671],[-58.8540290759838,-27.4942946245582],[-58.854183732476,-27.4941662607987],[-58.854194898214,-27.4939270391394],[-58.8539268682295,-27.4939306110893],[-58.8535463715638,-27.4938635080086],[-58.8538939558885,-27.4937776821611],[-58.8539055756739,-27.4935655192964],[-58.8540575862843,-27.4932793126388],[-58.8540687523255,-27.4930400909517],[-58.8538610265593,-27.4927180807535],[-58.8538059973334,-27.4924526762187],[-58.8538625211389,-27.4919016042449],[-58.8541843539735,-27.4914868318891],[-58.854610348742,-27.4912511028231]]]}"
113,528,569,1097,268,225,37.51,29,"{""type"":""Polygon"",""coordinates"":[[[-58.8457398207961,-27.4925554082516],[-58.8455432697045,-27.4925986130328],[-58.8447916365118,-27.4927213519802],[-58.8440858164063,-27.4928615229898],[-58.8438790745266,-27.4929003497081],[-58.843334479881,-27.4930022935405],[-58.8426134090954,-27.4931381484298],[-58.8418770897176,-27.4932696906858],[-58.8419168444969,-27.4935307923278],[-58.8420513569371,-27.494318406028],[-58.8410403625307,-27.4943588533129],[-58.8409586214368,-27.494310315878],[-58.839853038813,-27.4944422227338],[-58.8399875381862,-27.4952298389993],[-58.8401242902392,-27.4961527500253],[-58.8402747166315,-27.4969852632926],[-58.8403871179013,-27.4976604003602],[-58.8413410855284,-27.4975350059164],[-58.8413002791528,-27.4972107666097],[-58.8415657391733,-27.497356109967],[-58.8418407889869,-27.4974697500496],[-58.8419354260289,-27.4976850165988],[-58.8420733269502,-27.4977643854623],[-58.842236514976,-27.4978434193089],[-58.8423536609811,-27.4978914869669],[-58.8424459708422,-27.4979669484053],[-58.8427058508362,-27.498080787595],[-58.8442211878859,-27.4979479361458],[-58.8442388412361,-27.4980965591943],[-58.8442947732666,-27.4981138609534],[-58.8443970489615,-27.4981801672728],[-58.8445136697597,-27.4981966642831],[-58.8447162662534,-27.49821202111],[-58.8447182968807,-27.4983337863186],[-58.8448155908345,-27.4984046691937],[-58.8448167942424,-27.4984768263486],[-58.8448173959479,-27.4985129049257],[-58.8448194267126,-27.4986346701221],[-58.8448628194137,-27.4988100166097],[-58.84496599874,-27.4989304403146],[-58.8451251861537,-27.4990726751436],[-58.8452078353495,-27.4991753276836],[-58.8453063341401,-27.4993183672824],[-58.845308967403,-27.4994762109933],[-58.8453505555596,-27.4995433215719],[-58.845431474774,-27.4995422480869],[-58.8455692298947,-27.4996125935868],[-58.8456108935103,-27.4996842138953],[-58.8458699526808,-27.4997484387794],[-58.8459663454535,-27.4997652029169],[-58.8461436576079,-27.4997808930784],[-58.8463248227989,-27.4997243588043],[-58.8464409184445,-27.4997092853794],[-58.8467187772926,-27.4996875536116],[-58.8468009766154,-27.4997631462028],[-58.8468270168922,-27.4998079086396],[-58.8468326014483,-27.499839410207],[-58.8468486021332,-27.4998888167454],[-58.8468995532707,-27.4999106943503],[-58.8469299733546,-27.499914801272],[-58.8469906629154,-27.4999139954638],[-58.8470513524737,-27.4999131896292],[-58.8470816219418,-27.4999082768865],[-58.8471066080113,-27.4998899018473],[-58.847151597978,-27.4998577287292],[-58.8471765840242,-27.4998393536783],[-58.8472067028353,-27.4998254212792],[-58.8472569008364,-27.4998022006003],[-58.8472873208987,-27.4998063074448],[-58.84732287374,-27.4998148569338],[-58.8473533691282,-27.4998234735783],[-58.8473894492357,-27.499863591753],[-58.8474000160927,-27.4998905163082],[-58.8474260566383,-27.4999352786187],[-58.8474771585515,-27.4999661756339],[-58.8475076539921,-27.4999747922418],[-58.8479756531476,-27.5001309650305],[-58.8480993018779,-27.4999624221988],[-58.8484046417653,-27.4997689110252],[-58.8486434800785,-27.4995311748715],[-58.848157362834,-27.4995015477771],[-58.8478185142406,-27.4995060493135],[-58.8474631374026,-27.4994295748647],[-58.847141494619,-27.4995556382528],[-58.8469598783582,-27.4995851146623],[-58.8468576751907,-27.4995233201965],[-58.8466944321103,-27.49883533251],[-58.8465374532151,-27.4982194344236],[-58.8476324953525,-27.4980605484747],[-58.8474927293145,-27.4972639902858],[-58.8473580982518,-27.4964718744307],[-58.8472284514279,-27.495675181296],[-58.8471953216817,-27.4955087209337],[-58.8470888429426,-27.494887641788],[-58.8460951262779,-27.4950541995291],[-58.845975680437,-27.4942618801513],[-58.8458611433453,-27.4934604737596],[-58.8457398207961,-27.4925554082516]]]}"
114,1030,1001,2031,482,376,16.84,121,"{""type"":""Polygon"",""coordinates"":[[[-58.8408544146398,-27.4932155635229],[-58.8402426463952,-27.4932326784223],[-58.8396561636938,-27.4932494562902],[-58.8388574289068,-27.4932780588731],[-58.8387057883497,-27.4932845738726],[-58.8381090405218,-27.4932924592274],[-58.8381041335225,-27.4939105080761],[-58.8381118137721,-27.494677248018],[-58.8381230151716,-27.4950469882048],[-58.8381351158955,-27.4954708464617],[-58.8381426840377,-27.4959263403952],[-58.8381605168824,-27.4963907203323],[-58.8381720936553,-27.4967830096131],[-58.8373698481359,-27.4969063784067],[-58.8363653809529,-27.497036923016],[-58.836335111643,-27.4970418334125],[-58.8358050614338,-27.4971074699985],[-58.8352346263201,-27.4971781481946],[-58.8342707618216,-27.4973171638544],[-58.8343546243819,-27.4977987174556],[-58.83440627355,-27.4981679248686],[-58.8344304670515,-27.4984066800836],[-58.8354200019476,-27.4982898784781],[-58.8359804026056,-27.4982238425983],[-58.8365307625066,-27.4981624478711],[-58.836864252178,-27.4981400014318],[-58.8381917277253,-27.4979645876227],[-58.8394435624586,-27.4978036939628],[-58.8403871179013,-27.4976604003602],[-58.8402747166315,-27.4969852632926],[-58.8401242902392,-27.4961527500253],[-58.8399875381862,-27.4952298389993],[-58.839853038813,-27.4944422227338],[-58.8409586214368,-27.494310315878],[-58.8410403625307,-27.4943588533129],[-58.8420513569371,-27.494318406028],[-58.8419168444969,-27.4935307923278],[-58.8418770897176,-27.4932696906858],[-58.8417610749933,-27.4932892698452],[-58.8408731128491,-27.4934273250506],[-58.8408544146398,-27.4932155635229]]]}"
136,636,778,1414,398,442,13.66,104,"{""type"":""Polygon"",""coordinates"":[[[-58.8421920247842,-27.4787632002814],[-58.8409053886408,-27.4789471257439],[-58.8395985963036,-27.4791358167077],[-58.8395290037854,-27.4792089099735],[-58.8384083240327,-27.4793364889506],[-58.8383521028984,-27.4793011448649],[-58.83768561184,-27.4793685878708],[-58.8369942859957,-27.4794634205649],[-58.8371409070535,-27.4806794124099],[-58.8372714639122,-27.4818414857919],[-58.8387399562996,-27.4816416574374],[-58.8398399074239,-27.481482773186],[-58.8405362241185,-27.4813833491565],[-58.8412329144128,-27.4813064709135],[-58.8425348219342,-27.4811268501563],[-58.8423581018931,-27.4799293080069],[-58.8422495691698,-27.4791819462153],[-58.8422325984767,-27.4790739108235],[-58.8421920247842,-27.4787632002814]]]}"
115,608,678,1286,346,350,8.54,151,"{""type"":""Polygon"",""coordinates"":[[[-58.8340413524517,-27.4959894917866],[-58.833597504122,-27.4960675158825],[-58.8329064436315,-27.4961848825861],[-58.8324473467872,-27.4962585931259],[-58.8323318496874,-27.4963097336318],[-58.8319538187121,-27.4963913964945],[-58.831086045216,-27.496529124569],[-58.83060671594,-27.4966030954212],[-58.8306914575427,-27.497138770391],[-58.8307364693618,-27.497413339337],[-58.8307860910205,-27.4976607825398],[-58.8308144382958,-27.4978453539322],[-58.8308758173971,-27.4981918808212],[-58.8309655447887,-27.4987229789642],[-58.8314249517244,-27.498667312218],[-58.8318691857657,-27.4986118437748],[-58.8323384076716,-27.4985380014397],[-58.8328430309181,-27.498463691115],[-58.8330299318878,-27.4984476959617],[-58.834322765312,-27.4983178835962],[-58.8344304670515,-27.4984066800836],[-58.83440627355,-27.4981679248686],[-58.8343546243819,-27.4977987174556],[-58.8342707618216,-27.4973171638544],[-58.8341813193378,-27.4968041078631],[-58.8340413524517,-27.4959894917866]]]}"
116,540,601,1141,296,294,7.73,148,"{""type"":""Polygon"",""coordinates"":[[[-58.83060671594,-27.4966030954212],[-58.8297439213792,-27.4967362388684],[-58.8293202211216,-27.4968094736615],[-58.828795447254,-27.4968885467657],[-58.8287565538661,-27.4969837857711],[-58.8285194532829,-27.4970229891638],[-58.8280853380148,-27.4970783137714],[-58.8271718873358,-27.4972075962898],[-58.8272607020514,-27.4976845793944],[-58.8273545005945,-27.4981569860731],[-58.8274390792036,-27.498683643889],[-58.8274966576196,-27.4991069068787],[-58.8281124031923,-27.4990221319614],[-58.8283901916311,-27.4989959268645],[-58.8288545844172,-27.4989356921583],[-58.8296934528417,-27.4988840634706],[-58.8301073441851,-27.498828999694],[-58.8302889650638,-27.4987995451354],[-58.8309655447887,-27.4987229789642],[-58.8308758173971,-27.4981918808212],[-58.8308144382958,-27.4978453539322],[-58.8307860910205,-27.4976607825398],[-58.8307364693618,-27.497413339337],[-58.8306914575427,-27.497138770391],[-58.83060671594,-27.4966030954212]]]}"
117,394,459,853,207,216,7.53,113,"{""type"":""Polygon"",""coordinates"":[[[-58.8271718873358,-27.4972075962898],[-58.8257088888874,-27.4974478356455],[-58.8252750676754,-27.4975211911138],[-58.8240790624646,-27.497694758251],[-58.8236148943123,-27.4977685065195],[-58.8238120560965,-27.498681624421],[-58.8240332445015,-27.4998244800789],[-58.8242887980461,-27.4996767817177],[-58.8243834031844,-27.4995853240248],[-58.8244127812544,-27.4995262976947],[-58.8256448778019,-27.4993928510054],[-58.8263716683588,-27.4992930937618],[-58.8269974566138,-27.4992036810225],[-58.8274966576196,-27.4991069068787],[-58.8274390792036,-27.498683643889],[-58.8273545005945,-27.4981569860731],[-58.8272607020514,-27.4976845793944],[-58.8271718873358,-27.4972075962898]]]}"
118,773,822,1595,422,445,39.95,40,"{""type"":""Polygon"",""coordinates"":[[[-58.8256448778019,-27.4993928510054],[-58.8244127812544,-27.4995262976947],[-58.8243834031844,-27.4995853240248],[-58.8242887980461,-27.4996767817177],[-58.8240332445015,-27.4998244800789],[-58.823697810746,-27.5000363771537],[-58.8236428470558,-27.5000776953753],[-58.8228338567264,-27.5007153069835],[-58.82190109738,-27.5012101880652],[-58.8218195816019,-27.5011751688972],[-58.8220152506047,-27.5019980917944],[-58.822198355485,-27.5026723207689],[-58.8222669890993,-27.5037675580991],[-58.8223154722914,-27.5045608323368],[-58.8223706493518,-27.5054532574074],[-58.8223849935058,-27.5063236631146],[-58.822360213236,-27.5072757766125],[-58.8223131239779,-27.5077951410251],[-58.8222476647333,-27.5081207796843],[-58.8221839888964,-27.5085546552671],[-58.8221717097073,-27.5090374767297],[-58.8233270788115,-27.5091531486347],[-58.8244521020253,-27.509269208941],[-58.8261701742159,-27.5094541582716],[-58.8264387674922,-27.5094822069859],[-58.8264058789938,-27.5090225332102],[-58.8263652512243,-27.5084005707594],[-58.8263349633568,-27.5077920049739],[-58.8263017782752,-27.5073142915689],[-58.8262731371426,-27.507111679792],[-58.8262740983486,-27.5068635708789],[-58.8262755064841,-27.5066425211407],[-58.8262705161394,-27.5063403602571],[-58.8262268441724,-27.5058402302061],[-58.8261955225626,-27.5054752632174],[-58.8261387571168,-27.5047948712491],[-58.8261580880655,-27.5044337499885],[-58.8261934794043,-27.5038198106103],[-58.8261650631739,-27.5036307282591],[-58.8261707042449,-27.5030532661726],[-58.8261843756653,-27.5023493949707],[-58.8261213698666,-27.5019036485239],[-58.8260532326331,-27.5014534585233],[-58.8258821528783,-27.5005896219144],[-58.8256448778019,-27.4993928510054]]]}"
143,337,474,811,291,383,8.1,100,"{""type"":""Polygon"",""coordinates"":[[[-58.8294470459151,-27.470514057494],[-58.8281543779724,-27.4706347896894],[-58.8268718188591,-27.4707553772994],[-58.8255996660007,-27.4708938601565],[-58.8257397508764,-27.4720287604384],[-58.8270120652435,-27.4718992954637],[-58.827101529087,-27.4730303472187],[-58.8283838906415,-27.4728962266138],[-58.8297068475831,-27.4727705823926],[-58.8296022634372,-27.4716442428117],[-58.8294470459151,-27.470514057494]]]}"
144,280,352,632,240,332,7.96,79,"{""type"":""Polygon"",""coordinates"":[[[-58.8255996660007,-27.4708938601565],[-58.824337101634,-27.4710006297634],[-58.8230701460841,-27.4711480433035],[-58.8232050751439,-27.4722785036721],[-58.8233452867539,-27.4734224270461],[-58.8246176211822,-27.4732929830759],[-58.8258746343055,-27.4731547068158],[-58.827101529087,-27.4730303472187],[-58.8270120652435,-27.4718992954637],[-58.8257397508764,-27.4720287604384],[-58.8255996660007,-27.4708938601565]]]}"
119,1106,1205,2311,565,524,25.77,90,"{""type"":""Polygon"",""coordinates"":[[[-58.8318691857657,-27.4986118437748],[-58.8314249517244,-27.498667312218],[-58.8309655447887,-27.4987229789642],[-58.8302889650638,-27.4987995451354],[-58.8301073441851,-27.498828999694],[-58.8296934528417,-27.4988840634706],[-58.8288545844172,-27.4989356921583],[-58.8283901916311,-27.4989959268645],[-58.8281124031923,-27.4990221319614],[-58.8274966576196,-27.4991069068787],[-58.8269974566138,-27.4992036810225],[-58.8263716683588,-27.4992930937618],[-58.8256448778019,-27.4993928510054],[-58.8258821528783,-27.5005896219144],[-58.8260532326331,-27.5014534585233],[-58.8261213698666,-27.5019036485239],[-58.8261843756653,-27.5023493949707],[-58.8261707042449,-27.5030532661726],[-58.826250137482,-27.5029620063916],[-58.8269063668866,-27.5028767045264],[-58.8275373068425,-27.5027917318701],[-58.827672329266,-27.5036154418375],[-58.8289444793126,-27.5034543731307],[-58.8287393733421,-27.5023699573813],[-58.8291384037529,-27.5023331347751],[-58.8297291757841,-27.5022667238923],[-58.830011656257,-27.502217899372],[-58.8305821218309,-27.5021472412203],[-58.8311980303296,-27.5020714716724],[-58.8312106643759,-27.5019179368747],[-58.8312525985671,-27.5017008646118],[-58.8313422910462,-27.5016184886976],[-58.8317407199145,-27.5015455799651],[-58.8323109563661,-27.5014613853797],[-58.8330228037725,-27.5013753224426],[-58.8334619899304,-27.5013199150859],[-58.8333598153333,-27.5006491474045],[-58.8333373170665,-27.5002073820762],[-58.8321508920974,-27.5003493170999],[-58.8320865941635,-27.4998269068421],[-58.8319886872738,-27.4994131992271],[-58.8318691857657,-27.4986118437748]]]}"
120,658,698,1356,322,322,16.16,84,"{""type"":""Polygon"",""coordinates"":[[[-58.8381917277253,-27.4979645876227],[-58.836864252178,-27.4981400014318],[-58.8365307625066,-27.4981624478711],[-58.8359804026056,-27.4982238425983],[-58.8354200019476,-27.4982898784781],[-58.8344304670515,-27.4984066800836],[-58.834322765312,-27.4983178835962],[-58.8330299318878,-27.4984476959617],[-58.8328430309181,-27.498463691115],[-58.8323384076716,-27.4985380014397],[-58.8318691857657,-27.4986118437748],[-58.8319886872738,-27.4994131992271],[-58.8320865941635,-27.4998269068421],[-58.8321508920974,-27.5003493170999],[-58.8333373170665,-27.5002073820762],[-58.8333598153333,-27.5006491474045],[-58.8334619899304,-27.5013199150859],[-58.8340576608538,-27.5012443998334],[-58.8343402858801,-27.5012045864268],[-58.8346180775309,-27.5011783686992],[-58.8352189538152,-27.5011118015313],[-58.8357339257712,-27.5010508763393],[-58.8358039080389,-27.5010003336114],[-58.8364349029352,-27.5009198312544],[-58.8365000580198,-27.5002739222873],[-58.8373123691133,-27.5001459138842],[-58.8376049549255,-27.5000969407497],[-58.8377714777081,-27.5000721866894],[-58.837968270436,-27.500042521653],[-58.8382205455651,-27.5000031015125],[-58.8382096392379,-27.4990424391323],[-58.8381917277253,-27.4979645876227]]]}"
121,779,830,1609,370,341,18.99,85,"{""type"":""Polygon"",""coordinates"":[[[-58.8403871179013,-27.4976604003602],[-58.8394435624586,-27.4978036939628],[-58.8381917277253,-27.4979645876227],[-58.8382096392379,-27.4990424391323],[-58.8382205455651,-27.5000031015125],[-58.8382912005525,-27.4999931461537],[-58.8389471747564,-27.4998942592281],[-58.8392752363404,-27.4998493244612],[-58.8393204958059,-27.5001374189352],[-58.8393584481426,-27.500290285203],[-58.8393749705995,-27.5003712616028],[-58.8393956930175,-27.5007047887349],[-58.839975582305,-27.5005933704464],[-58.8409189352391,-27.500436542662],[-58.8412978726481,-27.5004089730756],[-58.8415099873856,-27.5003881218649],[-58.8417220269303,-27.5003627605057],[-58.8434817348106,-27.5003214075551],[-58.8443313932088,-27.5003101447358],[-58.8448613763669,-27.500239965349],[-58.8451979707502,-27.5001001763008],[-58.8455811349559,-27.500022920048],[-58.8457474294846,-27.4999846270713],[-58.8460850003581,-27.4999034636008],[-58.8468009766154,-27.4997631462028],[-58.8467187772926,-27.4996875536116],[-58.8464409184445,-27.4997092853794],[-58.8463248227989,-27.4997243588043],[-58.8461436576079,-27.4997808930784],[-58.8459663454535,-27.4997652029169],[-58.8458699526808,-27.4997484387794],[-58.8456108935103,-27.4996842138953],[-58.8455692298947,-27.4996125935868],[-58.845431474774,-27.4995422480869],[-58.8453505555596,-27.4995433215719],[-58.845308967403,-27.4994762109933],[-58.8453063341401,-27.4993183672824],[-58.8452078353495,-27.4991753276836],[-58.8451251861537,-27.4990726751436],[-58.84496599874,-27.4989304403146],[-58.8448628194137,-27.4988100166097],[-58.8448194267126,-27.4986346701221],[-58.8448173959479,-27.4985129049257],[-58.8448167942424,-27.4984768263486],[-58.8448155908345,-27.4984046691937],[-58.8447182968807,-27.4983337863186],[-58.8447162662534,-27.49821202111],[-58.8445136697597,-27.4981966642831],[-58.8443970489615,-27.4981801672728],[-58.8442947732666,-27.4981138609534],[-58.8442388412361,-27.4980965591943],[-58.8442211878859,-27.4979479361458],[-58.8427058508362,-27.498080787595],[-58.8424459708422,-27.4979669484053],[-58.8423536609811,-27.4978914869669],[-58.842236514976,-27.4978434193089],[-58.8420733269502,-27.4977643854623],[-58.8419354260289,-27.4976850165988],[-58.8418407889869,-27.4974697500496],[-58.8415657391733,-27.497356109967],[-58.8413002791528,-27.4972107666097],[-58.8413410855284,-27.4975350059164],[-58.8403871179013,-27.4976604003602]]]}"
122,884,930,1814,416,425,51.48,35,"{""type"":""Polygon"",""coordinates"":[[[-58.8468009766154,-27.4997631462028],[-58.8460850003581,-27.4999034636008],[-58.8457474294846,-27.4999846270713],[-58.8455811349559,-27.500022920048],[-58.8451979707502,-27.5001001763008],[-58.8448613763669,-27.500239965349],[-58.8443313932088,-27.5003101447358],[-58.8434817348106,-27.5003214075551],[-58.8417220269303,-27.5003627605057],[-58.8415099873856,-27.5003881218649],[-58.8412978726481,-27.5004089730756],[-58.8409189352391,-27.500436542662],[-58.839975582305,-27.5005933704464],[-58.8393956930175,-27.5007047887349],[-58.8393749705995,-27.5003712616028],[-58.8393584481426,-27.500290285203],[-58.8393204958059,-27.5001374189352],[-58.8392752363404,-27.4998493244612],[-58.8389471747564,-27.4998942592281],[-58.8382912005525,-27.4999931461537],[-58.8382205455651,-27.5000031015125],[-58.837968270436,-27.500042521653],[-58.8377714777081,-27.5000721866894],[-58.8376049549255,-27.5000969407497],[-58.8373123691133,-27.5001459138842],[-58.8365000580198,-27.5002739222873],[-58.8364349029352,-27.5009198312544],[-58.8363924550703,-27.5011053356988],[-58.8363594482982,-27.5012501180196],[-58.8361847473671,-27.5020012221046],[-58.8360744871542,-27.50236805482],[-58.8359507004484,-27.502834304258],[-58.8359649333655,-27.5030822120392],[-58.8360387687087,-27.5035684070306],[-58.8360678755427,-27.5037980751102],[-58.8361027889664,-27.5040727748124],[-58.8361028977403,-27.5043840205767],[-58.8360259428801,-27.5046241103605],[-58.8359298799013,-27.5049321147632],[-58.8359307034889,-27.5049817230089],[-58.8359364350631,-27.505022244812],[-58.8359471495,-27.5050581900123],[-58.8359743099958,-27.5051706022086],[-58.8360678201991,-27.5053182251627],[-58.8360781603184,-27.5053316211484],[-58.8362820426188,-27.5054236569384],[-58.8368645072807,-27.5054655848313],[-58.8371530235406,-27.5054753066651],[-58.8376951015598,-27.505522275332],[-58.8380493686289,-27.5055311265351],[-58.8382866328349,-27.505500925878],[-58.8385047905951,-27.5055386397511],[-58.8386262514444,-27.5055415449896],[-58.8387016676901,-27.5055134830651],[-58.8387167659318,-27.5055087726421],[-58.8387567779412,-27.5054811787297],[-58.8388269113956,-27.5054396541068],[-58.8389654532237,-27.5052528786119],[-58.8389801764333,-27.5052256189994],[-58.8390933541459,-27.505034667923],[-58.8390931291436,-27.5050211384256],[-58.8415116932593,-27.5050477783826],[-58.8417846595481,-27.5050351424008],[-58.8420626083306,-27.5050179290771],[-58.8423003207133,-27.5050147806222],[-58.8425738127335,-27.5050337118657],[-58.8428690387521,-27.5051425709707],[-58.8431587565988,-27.5052244375113],[-58.8428683929492,-27.5057109426481],[-58.842724100742,-27.5061594254561],[-58.842567715177,-27.5067930118876],[-58.842776985792,-27.5066007849314],[-58.8429440647797,-27.5063053679496],[-58.8432208348601,-27.5059137699684],[-58.8435575439426,-27.5054762688418],[-58.8438341594909,-27.505075650163],[-58.8440544616913,-27.5046351802539],[-58.8442361810862,-27.5043079920482],[-58.8444030273363,-27.5039990441231],[-58.8445791605596,-27.5036403538723],[-58.8447450269995,-27.5032727779543],[-58.8448677812915,-27.5030501198244],[-58.8451476382396,-27.5025411961994],[-58.8454008345144,-27.5022536557939],[-58.8456300210633,-27.5020431174201],[-58.8457984408248,-27.5018288742542],[-58.8458815590966,-27.5016563602527],[-58.8459874664769,-27.5016369115208],[-58.8461675808505,-27.5015172398769],[-58.8464289165055,-27.5014145331501],[-58.8465934056686,-27.5012680034993],[-58.8469290216529,-27.5010695826354],[-58.8471128358942,-27.5008686660344],[-58.8474069351685,-27.5006076439682],[-58.8477276765402,-27.5004274620869],[-58.8479474933645,-27.5002621527346],[-58.8479756531476,-27.5001309650305],[-58.8475076539921,-27.4999747922418],[-58.8474771585515,-27.4999661756339],[-58.8474260566383,-27.4999352786187],[-58.8474000160927,-27.4998905163082],[-58.8473894492357,-27.499863591753],[-58.8473533691282,-27.4998234735783],[-58.84732287374,-27.4998148569338],[-58.8472873208987,-27.4998063074448],[-58.8472569008364,-27.4998022006003],[-58.8472067028353,-27.4998254212792],[-58.8471765840242,-27.4998393536783],[-58.847151597978,-27.4998577287292],[-58.8471066080113,-27.4998899018473],[-58.8470816219418,-27.4999082768865],[-58.8470513524737,-27.4999131896292],[-58.8469906629154,-27.4999139954638],[-58.8469299733546,-27.499914801272],[-58.8468995532707,-27.4999106943503],[-58.8468486021332,-27.4998888167454],[-58.8468326014483,-27.499839410207],[-58.8468270168922,-27.4998079086396],[-58.8468009766154,-27.4997631462028]]]}"
123,754,770,1524,344,297,9.73,157,"{""type"":""Polygon"",""coordinates"":[[[-58.8364349029352,-27.5009198312544],[-58.8358039080389,-27.5010003336114],[-58.8357339257712,-27.5010508763393],[-58.8352189538152,-27.5011118015313],[-58.8346180775309,-27.5011783686992],[-58.8343402858801,-27.5012045864268],[-58.8340576608538,-27.5012443998334],[-58.8334619899304,-27.5013199150859],[-58.8330228037725,-27.5013753224426],[-58.8330975963729,-27.5019201478434],[-58.8331707453499,-27.5023657564462],[-58.8332452406219,-27.5028925422309],[-58.8333294782773,-27.5033966453369],[-58.8333885779471,-27.5039101013486],[-58.8334722191544,-27.5043781254511],[-58.8348256634389,-27.5042384854086],[-58.8361027889664,-27.5040727748124],[-58.8360678755427,-27.5037980751102],[-58.8360387687087,-27.5035684070306],[-58.8359649333655,-27.5030822120392],[-58.8359507004484,-27.502834304258],[-58.8360744871542,-27.50236805482],[-58.8361847473671,-27.5020012221046],[-58.8363594482982,-27.5012501180196],[-58.8363924550703,-27.5011053356988],[-58.8364349029352,-27.5009198312544]]]}"
155,339,418,757,238,277,9.79,77,"{""type"":""Polygon"",""coordinates"":[[[-58.834384826016,-27.4797865331943],[-58.8330723549668,-27.4799391516016],[-58.833011750554,-27.4799444606702],[-58.8318757336056,-27.4800631678042],[-58.8305326164307,-27.4801981224435],[-58.8306082710567,-27.4807970704905],[-58.8306837029498,-27.4813824888003],[-58.8307432198894,-27.481923007863],[-58.83080266298,-27.482459016964],[-58.8321607531087,-27.4823103291199],[-58.8333521920675,-27.4821773562241],[-58.8346821014073,-27.4821598297056],[-58.8347161527279,-27.4820781855958],[-58.8346459798238,-27.4815062335095],[-58.8345762562646,-27.4809613404648],[-58.834384826016,-27.4797865331943]]]}"
124,592,672,1264,303,297,11.17,113,"{""type"":""Polygon"",""coordinates"":[[[-58.8330228037725,-27.5013753224426],[-58.8323109563661,-27.5014613853797],[-58.8317407199145,-27.5015455799651],[-58.8313422910462,-27.5016184886976],[-58.8312525985671,-27.5017008646118],[-58.8312106643759,-27.5019179368747],[-58.8311980303296,-27.5020714716724],[-58.831298326862,-27.5026294950454],[-58.8313772737419,-27.503120136824],[-58.8314518359402,-27.5036514337605],[-58.8315356928252,-27.5041329890109],[-58.8316151650962,-27.5046551994119],[-58.8316939659709,-27.5051368210336],[-58.8317335007618,-27.5056911330416],[-58.8323747165835,-27.5056150243408],[-58.8326875505985,-27.5055657942433],[-58.8328742393016,-27.5055362691835],[-58.833217269823,-27.5054776183108],[-58.8337217741088,-27.5053942836568],[-58.8349628374822,-27.5051884609987],[-58.8357412049806,-27.5051466140719],[-58.8359364350631,-27.505022244812],[-58.8359307034889,-27.5049817230089],[-58.8359298799013,-27.5049321147632],[-58.8360259428801,-27.5046241103605],[-58.8361028977403,-27.5043840205767],[-58.8361027889664,-27.5040727748124],[-58.8348256634389,-27.5042384854086],[-58.8334722191544,-27.5043781254511],[-58.8333885779471,-27.5039101013486],[-58.8333294782773,-27.5033966453369],[-58.8332452406219,-27.5028925422309],[-58.8331707453499,-27.5023657564462],[-58.8330975963729,-27.5019201478434],[-58.8330228037725,-27.5013753224426]]]}"
125,523,575,1098,264,266,19.51,56,"{""type"":""Polygon"",""coordinates"":[[[-58.8311980303296,-27.5020714716724],[-58.8305821218309,-27.5021472412203],[-58.830011656257,-27.502217899372],[-58.8297291757841,-27.5022667238923],[-58.8291384037529,-27.5023331347751],[-58.8287393733421,-27.5023699573813],[-58.8289444793126,-27.5034543731307],[-58.827672329266,-27.5036154418375],[-58.8275373068425,-27.5027917318701],[-58.8269063668866,-27.5028767045264],[-58.826250137482,-27.5029620063916],[-58.8261707042449,-27.5030532661726],[-58.8261650631739,-27.5036307282591],[-58.8261934794043,-27.5038198106103],[-58.8261580880655,-27.5044337499885],[-58.8261387571168,-27.5047948712491],[-58.8261955225626,-27.5054752632174],[-58.8262268441724,-27.5058402302061],[-58.8262705161394,-27.5063403602571],[-58.8270994015989,-27.5062933871668],[-58.8278161943014,-27.5061982630676],[-58.8283819972548,-27.5061502286775],[-58.8290325140352,-27.5060243937426],[-58.8303398693859,-27.5058493159113],[-58.8311779673489,-27.5057480674142],[-58.8317335007618,-27.5056911330416],[-58.8316939659709,-27.5051368210336],[-58.8316151650962,-27.5046551994119],[-58.8315356928252,-27.5041329890109],[-58.8314518359402,-27.5036514337605],[-58.8313772737419,-27.503120136824],[-58.831298326862,-27.5026294950454],[-58.8311980303296,-27.5020714716724]]]}"
140,448,491,939,231,200,28.11,33,"{""type"":""Polygon"",""coordinates"":[[[-58.8566251377482,-27.4768753429516],[-58.8553737992509,-27.4770499082353],[-58.8547668806454,-27.4770489758897],[-58.8537321311737,-27.4771710210528],[-58.8525760250179,-27.4772946739769],[-58.8519711411285,-27.4774154945656],[-58.8512088278133,-27.4774978092006],[-58.8505335277771,-27.4776421143195],[-58.8499892411879,-27.4777576098838],[-58.850150491963,-27.4789327913477],[-58.8503369542914,-27.4801031263054],[-58.8515493186132,-27.4800148290117],[-58.8516481788885,-27.4807848639632],[-58.8525802489838,-27.4808716975961],[-58.8528732285005,-27.4808497539326],[-58.8529653791862,-27.4809161892857],[-58.8530584358954,-27.4810367423209],[-58.8531443978124,-27.4810355976869],[-58.8536346597514,-27.4810155360921],[-58.8538128484506,-27.4810853356717],[-58.8541122443552,-27.4811444986033],[-58.85412417041,-27.4812525992965],[-58.8541711905035,-27.4813421891559],[-58.854238588154,-27.4814405291199],[-58.8543558720292,-27.4814976069926],[-58.8545128533073,-27.4815090476111],[-58.8546234940576,-27.4814714866593],[-58.8547026617302,-27.4813666828496],[-58.8552835728268,-27.4816250777409],[-58.8553905174054,-27.4816687601091],[-58.8559230487506,-27.481756386317],[-58.8567533912908,-27.4818084616578],[-58.8569144341439,-27.48145898042],[-58.8569617227936,-27.4806599357312],[-58.857029766749,-27.4798921897101],[-58.8569656843437,-27.4796900582099],[-58.8569594695066,-27.4790180300173],[-58.8568494786597,-27.4781895078698],[-58.8567740527199,-27.4773109054105],[-58.8567025824163,-27.4772712615326],[-58.8566251377482,-27.4768753429516]]]}"
141,287,334,621,188,265,9.5,65,"{""type"":""Polygon"",""coordinates"":[[[-58.8358391728553,-27.4698886026299],[-58.8346676458552,-27.4699942646812],[-58.8333450290523,-27.4701379937001],[-58.8320525957614,-27.4702722913118],[-58.8321719981245,-27.4713758790989],[-58.8323022622474,-27.4725244320951],[-58.8335743468997,-27.4723813776118],[-58.8349530568311,-27.4722639711769],[-58.8360892884866,-27.4721632823134],[-58.8359791358763,-27.4710099580998],[-58.8358391728553,-27.4698886026299]]]}"
126,618,613,1231,285,276,104.67,12,"{""type"":""Polygon"",""coordinates"":[[[-58.8359364350631,-27.505022244812],[-58.8357412049806,-27.5051466140719],[-58.8349628374822,-27.5051884609987],[-58.8337217741088,-27.5053942836568],[-58.833217269823,-27.5054776183108],[-58.8328742393016,-27.5055362691835],[-58.8326875505985,-27.5055657942433],[-58.8323747165835,-27.5056150243408],[-58.8317335007618,-27.5056911330416],[-58.8311779673489,-27.5057480674142],[-58.8309942646267,-27.5059579843319],[-58.8306201203119,-27.5068876306123],[-58.8302946825726,-27.5077038641339],[-58.8300955953969,-27.5082071867545],[-58.8298618474935,-27.5087560735238],[-58.8297891133562,-27.5089464855848],[-58.8297381376511,-27.509840301635],[-58.8296760924822,-27.5109823591265],[-58.8295943943959,-27.5118540249969],[-58.8297119986231,-27.5119291618696],[-58.8296618831994,-27.5122636229438],[-58.8295684091617,-27.5127294686239],[-58.8294777535367,-27.5130599521587],[-58.8294516589626,-27.5133174129623],[-58.8292820873087,-27.5137707270709],[-58.8291667363384,-27.5141376219484],[-58.8300488725262,-27.5142478079156],[-58.8318944536071,-27.5144896458709],[-58.8330289795404,-27.514564911738],[-58.833974707937,-27.5145434202587],[-58.8346397980059,-27.5146835041429],[-58.8350812066876,-27.5147588744891],[-58.835734235513,-27.5147818307951],[-58.836447662817,-27.51478594308],[-58.8365069741321,-27.5150061900484],[-58.8366768166079,-27.5151798688541],[-58.8373812542944,-27.5152517572995],[-58.8373932803893,-27.51506214392],[-58.8375473101911,-27.5148932081852],[-58.8378081204588,-27.514452211845],[-58.8379163599198,-27.5139636126512],[-58.8380316062594,-27.5135922021018],[-58.8380976956671,-27.5133071468305],[-58.8383148524533,-27.5129794971809],[-58.83856523938,-27.5125205940884],[-58.8386343598426,-27.5121137063622],[-58.838781150504,-27.5118140513231],[-58.8388094733994,-27.5116918846619],[-58.8387315778275,-27.5115711224665],[-58.8388822682331,-27.5115059784524],[-58.839501238591,-27.5106993771849],[-58.8396344271539,-27.5104946284828],[-58.8402433458093,-27.5096926679848],[-58.840301563827,-27.5095430405592],[-58.8404201013403,-27.5093700607858],[-58.8407421084166,-27.5089598253787],[-58.8411452644353,-27.5085620474805],[-58.8411731334971,-27.5084128215024],[-58.8414576765859,-27.5081835133052],[-58.8418546425725,-27.5077181531823],[-58.8420786388398,-27.5074986672674],[-58.8422712354172,-27.5072164454913],[-58.842567715177,-27.5067930118876],[-58.842724100742,-27.5061594254561],[-58.8428683929492,-27.5057109426481],[-58.8431587565988,-27.5052244375113],[-58.8428690387521,-27.5051425709707],[-58.8425738127335,-27.5050337118657],[-58.8423003207133,-27.5050147806222],[-58.8420626083306,-27.5050179290771],[-58.8417846595481,-27.5050351424008],[-58.8415116932593,-27.5050477783826],[-58.8390931291436,-27.5050211384256],[-58.8390933541459,-27.505034667923],[-58.8389801764333,-27.5052256189994],[-58.8389654532237,-27.5052528786119],[-58.8388269113956,-27.5054396541068],[-58.8387567779412,-27.5054811787297],[-58.8387167659318,-27.5055087726421],[-58.8387016676901,-27.5055134830651],[-58.8386262514444,-27.5055415449896],[-58.8385047905951,-27.5055386397511],[-58.8382866328349,-27.505500925878],[-58.8380493686289,-27.5055311265351],[-58.8376951015598,-27.505522275332],[-58.8371530235406,-27.5054753066651],[-58.8368645072807,-27.5054655848313],[-58.8362820426188,-27.5054236569384],[-58.8360781603184,-27.5053316211484],[-58.8360678201991,-27.5053182251627],[-58.8359743099958,-27.5051706022086],[-58.8359471495,-27.5050581900123],[-58.8359364350631,-27.505022244812]]]}"
127,434,457,891,236,234,56.31,16,"{""type"":""Polygon"",""coordinates"":[[[-58.8311779673489,-27.5057480674142],[-58.8303398693859,-27.5058493159113],[-58.8290325140352,-27.5060243937426],[-58.8283819972548,-27.5061502286775],[-58.8278161943014,-27.5061982630676],[-58.8270994015989,-27.5062933871668],[-58.8262705161394,-27.5063403602571],[-58.8262755064841,-27.5066425211407],[-58.8262740983486,-27.5068635708789],[-58.8262731371426,-27.507111679792],[-58.8263017782752,-27.5073142915689],[-58.8263349633568,-27.5077920049739],[-58.8263652512243,-27.5084005707594],[-58.8264058789938,-27.5090225332102],[-58.8264387674922,-27.5094822069859],[-58.8261701742159,-27.5094541582716],[-58.8244521020253,-27.509269208941],[-58.8233270788115,-27.5091531486347],[-58.8221717097073,-27.5090374767297],[-58.821894907058,-27.5109672345026],[-58.8217533562464,-27.5109735996982],[-58.8213734087756,-27.5109424896181],[-58.8210438190035,-27.5108971865448],[-58.8207448004961,-27.5108650149728],[-58.8205522979681,-27.5108494917769],[-58.820441466674,-27.5108780077179],[-58.8203356933593,-27.510906457366],[-58.8201145501844,-27.5109950579631],[-58.8198985389261,-27.5110881019097],[-58.8197284951757,-27.5112076091364],[-58.8196302288869,-27.511384818041],[-58.8196465907333,-27.5114567775307],[-58.8196924432573,-27.51270568251],[-58.8196492955665,-27.5128505942422],[-58.8216336427198,-27.5129193422665],[-58.8215787415059,-27.5132719073356],[-58.8278031067249,-27.5139751191547],[-58.8283354069636,-27.5140402948153],[-58.828639568098,-27.514076892856],[-58.8291667363384,-27.5141376219484],[-58.8292820873087,-27.5137707270709],[-58.8294516589626,-27.5133174129623],[-58.8294777535367,-27.5130599521587],[-58.8295684091617,-27.5127294686239],[-58.8296618831994,-27.5122636229438],[-58.8297119986231,-27.5119291618696],[-58.8295943943959,-27.5118540249969],[-58.8296760924822,-27.5109823591265],[-58.8297381376511,-27.509840301635],[-58.8297891133562,-27.5089464855848],[-58.8298618474935,-27.5087560735238],[-58.8300955953969,-27.5082071867545],[-58.8302946825726,-27.5077038641339],[-58.8306201203119,-27.5068876306123],[-58.8309942646267,-27.5059579843319],[-58.8311779673489,-27.5057480674142]]]}"
128,292,326,618,198,220,22.73,27,"{""type"":""Polygon"",""coordinates"":[[[-58.8563462432948,-27.4732117693813],[-58.856023098913,-27.4732431434899],[-58.8559623486954,-27.4732394427064],[-58.8559320113799,-27.4732398472096],[-58.8558712611647,-27.4732361463861],[-58.8558409238485,-27.4732365508695],[-58.8557801736357,-27.4732328500059],[-58.8557194234252,-27.4732291491156],[-58.8556991985474,-27.4732294187498],[-58.8556840298888,-27.4732296209735],[-58.8547301414107,-27.4733460834425],[-58.8524088013892,-27.4736476448697],[-58.8517373760645,-27.4737197302574],[-58.8512478241678,-27.4737803720016],[-58.8500166586036,-27.4739501090438],[-58.8496793952173,-27.4740448077759],[-58.8494424282313,-27.4740885540057],[-58.8490139248565,-27.4741709309535],[-58.8493037898796,-27.4742663182874],[-58.8495268690288,-27.4742994408721],[-58.8496741793181,-27.4743380808167],[-58.8507688881039,-27.4750813477137],[-58.8509524986979,-27.47517363345],[-58.8510186078359,-27.4751953084192],[-58.8511483947891,-27.4763032449428],[-58.8511807688646,-27.4764246065873],[-58.851781044665,-27.4763309158293],[-58.8519711411285,-27.4774154945656],[-58.8525760250179,-27.4772946739769],[-58.8537321311737,-27.4771710210528],[-58.8547668806454,-27.4770489758897],[-58.8553737992509,-27.4770499082353],[-58.8566251377482,-27.4768753429516],[-58.856569864881,-27.4759919604915],[-58.8565419065314,-27.4749277809079],[-58.8565746341619,-27.4741650164304],[-58.8565008220932,-27.4739855682767],[-58.8564600601367,-27.4736658439501],[-58.8564383230527,-27.4735759175243],[-58.8563462432948,-27.4732117693813]]]}"
129,535,562,1097,269,267,10.43,105,"{""type"":""Polygon"",""coordinates"":[[[-58.8490139248565,-27.4741709309535],[-58.8481104308257,-27.4742776574227],[-58.8482131116247,-27.4749754724534],[-58.848309307272,-27.4755876676907],[-58.8485155162905,-27.4767306793074],[-58.8486161697516,-27.4773067282619],[-58.8486765234349,-27.4778923340128],[-58.8499892411879,-27.4777576098838],[-58.8505335277771,-27.4776421143195],[-58.8512088278133,-27.4774978092006],[-58.8519711411285,-27.4774154945656],[-58.851781044665,-27.4763309158293],[-58.8511807688646,-27.4764246065873],[-58.8511483947891,-27.4763032449428],[-58.8510186078359,-27.4751953084192],[-58.8509524986979,-27.47517363345],[-58.8507688881039,-27.4750813477137],[-58.8496741793181,-27.4743380808167],[-58.8495268690288,-27.4742994408721],[-58.8493037898796,-27.4742663182874],[-58.8490139248565,-27.4741709309535]]]}"
130,400,453,853,284,321,13.8,62,"{""type"":""Polygon"",""coordinates"":[[[-58.8481104308257,-27.4742776574227],[-58.8477620736268,-27.474313858111],[-58.8473986977454,-27.4743592789292],[-58.846894121262,-27.474429126597],[-58.8462128741498,-27.4745193592437],[-58.8456074703968,-27.4746085829564],[-58.8456945910629,-27.4752840525403],[-58.845790998802,-27.4759097796694],[-58.8459420133494,-27.4770805929176],[-58.8460826932966,-27.4782380103025],[-58.8462489604093,-27.4794131311494],[-58.8475666817193,-27.4792738519672],[-58.8488582126176,-27.4790807784382],[-58.8486765234349,-27.4778923340128],[-58.8486161697516,-27.4773067282619],[-58.8485155162905,-27.4767306793074],[-58.848309307272,-27.4755876676907],[-58.8482131116247,-27.4749754724534],[-58.8481104308257,-27.4742776574227]]]}"
131,294,347,641,204,244,6.95,92,"{""type"":""Polygon"",""coordinates"":[[[-58.8456074703968,-27.4746085829564],[-58.8448453948075,-27.4747043915451],[-58.844305495438,-27.4747792089347],[-58.8444126835746,-27.4754453920147],[-58.8444791216685,-27.4760940716017],[-58.8446450666883,-27.4772511563598],[-58.8446612879375,-27.4773140930195],[-58.8447804515496,-27.4783951132041],[-58.8449569686647,-27.4795791218553],[-58.8462489604093,-27.4794131311494],[-58.8460826932966,-27.4782380103025],[-58.8459420133494,-27.4770805929176],[-58.845790998802,-27.4759097796694],[-58.8456945910629,-27.4752840525403],[-58.8456074703968,-27.4746085829564]]]}"
132,304,393,697,255,310,6.92,101,"{""type"":""Polygon"",""coordinates"":[[[-58.844305495438,-27.4747792089347],[-58.8435837926619,-27.4748699648924],[-58.842983365453,-27.4749546005667],[-58.8430954521543,-27.475611698394],[-58.8431775774347,-27.4762917469753],[-58.8433533970024,-27.4774351704527],[-58.8420564407378,-27.4776057101538],[-58.8421920247842,-27.4787632002814],[-58.8434886187408,-27.4785701094944],[-58.8447804515496,-27.4783951132041],[-58.8446612879375,-27.4773140930195],[-58.8446450666883,-27.4772511563598],[-58.8444791216685,-27.4760940716017],[-58.8444126835746,-27.4754453920147],[-58.844305495438,-27.4747792089347]]]}"
133,413,457,870,274,330,8.99,97,"{""type"":""Polygon"",""coordinates"":[[[-58.842983365453,-27.4749546005667],[-58.842251622386,-27.4750499934653],[-58.8416811558609,-27.4751116728425],[-58.8412017028538,-27.4751721459916],[-58.8411865338048,-27.475172346649],[-58.8403538099656,-27.4752780870846],[-58.840460600354,-27.47592172507],[-58.840563385374,-27.4766285675821],[-58.8407295158284,-27.4777991884373],[-58.8409053886408,-27.4789471257439],[-58.8421920247842,-27.4787632002814],[-58.8420564407378,-27.4776057101538],[-58.8433533970024,-27.4774351704527],[-58.8431775774347,-27.4762917469753],[-58.8430954521543,-27.475611698394],[-58.842983365453,-27.4749546005667]]]}"
134,262,366,628,217,267,6.81,92,"{""type"":""Polygon"",""coordinates"":[[[-58.840563385374,-27.4766285675821],[-58.839251188375,-27.4767947716449],[-58.8379542308732,-27.4769652730582],[-58.8381460663714,-27.4781626235123],[-58.8383521028984,-27.4793011448649],[-58.8384083240327,-27.4793364889506],[-58.8395290037854,-27.4792089099735],[-58.8395985963036,-27.4791358167077],[-58.8409053886408,-27.4789471257439],[-58.8407295158284,-27.4777991884373],[-58.840563385374,-27.4766285675821]]]}"
135,295,338,633,216,229,9.35,68,"{""type"":""Polygon"",""coordinates"":[[[-58.8403538099656,-27.4752780870846],[-58.8396927008802,-27.475363511038],[-58.8390770978999,-27.4754483306203],[-58.8389004245933,-27.4754687082504],[-58.8377446113183,-27.4756102773065],[-58.8375478615696,-27.4756399399987],[-58.8364625343702,-27.4757625245577],[-58.8365493764998,-27.4764244728852],[-58.836626855121,-27.4771316530646],[-58.8366582412108,-27.477194390709],[-58.8368069176653,-27.4782299226563],[-58.8368282660187,-27.4782973035548],[-58.8369942859957,-27.4794634205649],[-58.83768561184,-27.4793685878708],[-58.8383521028984,-27.4793011448649],[-58.8381460663714,-27.4781626235123],[-58.8379542308732,-27.4769652730582],[-58.839251188375,-27.4767947716449],[-58.840563385374,-27.4766285675821],[-58.840460600354,-27.47592172507],[-58.8403538099656,-27.4752780870846]]]}"
137,565,676,1241,381,412,17.51,71,"{""type"":""Polygon"",""coordinates"":[[[-58.8447804515496,-27.4783951132041],[-58.8434886187408,-27.4785701094944],[-58.8421920247842,-27.4787632002814],[-58.8422325984767,-27.4790739108235],[-58.8422495691698,-27.4791819462153],[-58.8423581018931,-27.4799293080069],[-58.8425348219342,-27.4811268501563],[-58.8427120721179,-27.4823559605635],[-58.8428627669662,-27.4835087379486],[-58.8430510409482,-27.4847918312501],[-58.843146969631,-27.4847815390259],[-58.8435864589592,-27.4847486522202],[-58.8443334343858,-27.4846530482662],[-58.8449690842229,-27.4845544055429],[-58.8456151470773,-27.4844736651518],[-58.8456137934653,-27.4843924882258],[-58.8454458681207,-27.4831181511826],[-58.8452850340186,-27.4819655119318],[-58.8451078315174,-27.4807409159459],[-58.8449569686647,-27.4795791218553],[-58.8447804515496,-27.4783951132041]]]}"
138,886,1002,1888,524,462,20.13,94,"{""type"":""Polygon"",""coordinates"":[[[-58.8488582126176,-27.4790807784382],[-58.8475666817193,-27.4792738519672],[-58.8462489604093,-27.4794131311494],[-58.8449569686647,-27.4795791218553],[-58.8451078315174,-27.4807409159459],[-58.8452850340186,-27.4819655119318],[-58.8454458681207,-27.4831181511826],[-58.8456137934653,-27.4843924882258],[-58.8456151470773,-27.4844736651518],[-58.8456765802509,-27.4845179586225],[-58.8462874705517,-27.4844512141084],[-58.8469485512171,-27.4843612466723],[-58.8472244146205,-27.4842222602922],[-58.8476808142122,-27.4839906599403],[-58.8481823458115,-27.4837359046396],[-58.8495497930392,-27.4829373646066],[-58.8494876811568,-27.4828524844871],[-58.8494120652876,-27.4825647968067],[-58.8493235402528,-27.4824126052797],[-58.8492588672241,-27.4821743911043],[-58.8491659069341,-27.4814538946952],[-58.8490143977024,-27.4802560286803],[-58.8488582126176,-27.4790807784382]]]}"
139,403,432,835,214,171,8.63,97,"{""type"":""Polygon"",""coordinates"":[[[-58.8499892411879,-27.4777576098838],[-58.8486765234349,-27.4778923340128],[-58.8488582126176,-27.4790807784382],[-58.8490143977024,-27.4802560286803],[-58.8491659069341,-27.4814538946952],[-58.8492588672241,-27.4821743911043],[-58.8493235402528,-27.4824126052797],[-58.8494120652876,-27.4825647968067],[-58.8494876811568,-27.4828524844871],[-58.8495497930392,-27.4829373646066],[-58.850326190338,-27.4824849831713],[-58.8505627274466,-27.4821119506599],[-58.8507880187294,-27.4816714050375],[-58.8510345150429,-27.4812892177138],[-58.851178290615,-27.4811158941357],[-58.8514177637114,-27.4809187432455],[-58.8516481788885,-27.4807848639632],[-58.8515493186132,-27.4800148290117],[-58.8503369542914,-27.4801031263054],[-58.850150491963,-27.4789327913477],[-58.8499892411879,-27.4777576098838]]]}"
142,290,415,705,208,261,6.48,109,"{""type"":""Polygon"",""coordinates"":[[[-58.8320525957614,-27.4702722913118],[-58.8307700472761,-27.4703929144483],[-58.8294470459151,-27.470514057494],[-58.8296022634372,-27.4716442428117],[-58.8297068475831,-27.4727705823926],[-58.8309997614502,-27.4726633642952],[-58.8323022622474,-27.4725244320951],[-58.8321719981245,-27.4713758790989],[-58.8320525957614,-27.4702722913118]]]}"
145,517,559,1076,273,265,28.23,38,"{""type"":""Polygon"",""coordinates"":[[[-58.819118919352,-27.4738295728817],[-58.8175084593156,-27.4740039802827],[-58.8167862871015,-27.474067538613],[-58.8161651673243,-27.4741252638691],[-58.814857561944,-27.4742641127938],[-58.8135900343634,-27.4743798729545],[-58.8139062401104,-27.475467385164],[-58.8142310562626,-27.476771306132],[-58.814544806947,-27.4780167287345],[-58.814688873902,-27.478474959669],[-58.814861995618,-27.4791628661114],[-58.8161340403749,-27.4790109466069],[-58.8173657763252,-27.4788685636801],[-58.8185569076835,-27.4787176787739],[-58.8186021946163,-27.4787035544188],[-58.81981362227,-27.478556904523],[-58.8198994355987,-27.4785467607139],[-58.8197865919046,-27.4778355191015],[-58.8197811647349,-27.4778130357215],[-58.8195300689156,-27.4760751231598],[-58.8193547930685,-27.4749496968589],[-58.819118919352,-27.4738295728817]]]}"
146,655,751,1406,446,478,13.54,104,"{""type"":""Polygon"",""coordinates"":[[[-58.8246176211822,-27.4732929830759],[-58.8233452867539,-27.4734224270461],[-58.8220372575142,-27.4735342832499],[-58.8207598595307,-27.4736637700407],[-58.8196643381552,-27.4737818459289],[-58.8196441127664,-27.473782110331],[-58.819118919352,-27.4738295728817],[-58.8193547930685,-27.4749496968589],[-58.8195300689156,-27.4760751231598],[-58.8201208582147,-27.4760177791884],[-58.8210802478703,-27.475924034479],[-58.8223123117896,-27.475804159145],[-58.8235141081149,-27.4756891803912],[-58.8240088203017,-27.4756330787241],[-58.8248771862829,-27.4755405008438],[-58.8247421599106,-27.4744055337359],[-58.8246176211822,-27.4732929830759]]]}"
147,658,767,1425,435,528,12.37,115,"{""type"":""Polygon"",""coordinates"":[[[-58.8248771862829,-27.4755405008438],[-58.8240088203017,-27.4756330787241],[-58.8235141081149,-27.4756891803912],[-58.8223123117896,-27.475804159145],[-58.8210802478703,-27.475924034479],[-58.8201208582147,-27.4760177791884],[-58.8195300689156,-27.4760751231598],[-58.8197811647349,-27.4778130357215],[-58.8197865919046,-27.4778355191015],[-58.8203618500084,-27.4777558225235],[-58.820467888753,-27.477745413854],[-58.8213109929178,-27.4776531880011],[-58.8225123653472,-27.4775111575464],[-58.8236935080717,-27.4773693818861],[-58.824652607545,-27.477257572586],[-58.8250766093795,-27.477206904743],[-58.8263331450862,-27.4770370530922],[-58.8262173614928,-27.4761499330259],[-58.8261345961855,-27.4754247704754],[-58.8248771862829,-27.4755405008438]]]}"
148,546,647,1193,432,504,13.83,86,"{""type"":""Polygon"",""coordinates"":[[[-58.8283838906415,-27.4728962266138],[-58.827101529087,-27.4730303472187],[-58.8258746343055,-27.4731547068158],[-58.8246176211822,-27.4732929830759],[-58.8247421599106,-27.4744055337359],[-58.8248771862829,-27.4755405008438],[-58.8261345961855,-27.4754247704754],[-58.8262173614928,-27.4761499330259],[-58.8263331450862,-27.4770370530922],[-58.827494050038,-27.4768955110381],[-58.8287863448348,-27.4767477222169],[-58.8286384739838,-27.4751438002233],[-58.8284988004879,-27.4740359642597],[-58.8283838906415,-27.4728962266138]]]}"
149,330,461,791,323,466,11.04,72,"{""type"":""Polygon"",""coordinates"":[[[-58.8309997614502,-27.4726633642952],[-58.8297068475831,-27.4727705823926],[-58.8283838906415,-27.4728962266138],[-58.8284988004879,-27.4740359642597],[-58.8286384739838,-27.4751438002233],[-58.8287863448348,-27.4767477222169],[-58.8295585666031,-27.4766518673214],[-58.8301436983474,-27.4765584683701],[-58.8310874631229,-27.4764377950729],[-58.8314003653607,-27.4763975914173],[-58.8314205910943,-27.4763973252844],[-58.8312541730367,-27.4748974010057],[-58.8311396064038,-27.473780216563],[-58.8309997614502,-27.4726633642952]]]}"
150,295,381,676,296,376,10.55,64,"{""type"":""Polygon"",""coordinates"":[[[-58.8335743468997,-27.4723813776118],[-58.8323022622474,-27.4725244320951],[-58.8309997614502,-27.4726633642952],[-58.8311396064038,-27.473780216563],[-58.8312541730367,-27.4748974010057],[-58.8314205910943,-27.4763973252844],[-58.8325056339169,-27.4762567400213],[-58.832712574035,-27.47623146105],[-58.8338028187825,-27.4760998189768],[-58.8339591193815,-27.4760706945001],[-58.8338246490915,-27.4746695921936],[-58.8337148145915,-27.4735343050137],[-58.8335743468997,-27.4723813776118]]]}"
151,240,322,562,207,238,10.14,55,"{""type"":""Polygon"",""coordinates"":[[[-58.8360892884866,-27.4721632823134],[-58.8349530568311,-27.4722639711769],[-58.8335743468997,-27.4723813776118],[-58.8337148145915,-27.4735343050137],[-58.8338246490915,-27.4746695921936],[-58.8339591193815,-27.4760706945001],[-58.8352463358896,-27.475922913172],[-58.8354027105195,-27.4758982969643],[-58.8364625343702,-27.4757625245577],[-58.8363394172495,-27.4744379603387],[-58.8362243516092,-27.473293723341],[-58.8360892884866,-27.4721632823134]]]}"
152,519,650,1169,427,477,14.21,82,"{""type"":""Polygon"",""coordinates"":[[[-58.8364625343702,-27.4757625245577],[-58.8354027105195,-27.4758982969643],[-58.8352463358896,-27.475922913172],[-58.8339591193815,-27.4760706945001],[-58.8338028187825,-27.4760998189768],[-58.8339095724683,-27.4767434637465],[-58.8340274117461,-27.4774456032779],[-58.834218683216,-27.478611392075],[-58.834384826016,-27.4797865331943],[-58.8345762562646,-27.4809613404648],[-58.8357976424148,-27.480805398214],[-58.8371409070535,-27.4806794124099],[-58.8369942859957,-27.4794634205649],[-58.8368282660187,-27.4782973035548],[-58.8368069176653,-27.4782299226563],[-58.8366582412108,-27.477194390709],[-58.836626855121,-27.4771316530646],[-58.8365493764998,-27.4764244728852],[-58.8364625343702,-27.4757625245577]]]}"
153,266,359,625,224,263,7.66,82,"{""type"":""Polygon"",""coordinates"":[[[-58.8338028187825,-27.4760998189768],[-58.832712574035,-27.47623146105],[-58.8325056339169,-27.4762567400213],[-58.8314205910943,-27.4763973252844],[-58.8314003653607,-27.4763975914173],[-58.8310874631229,-27.4764377950729],[-58.8301436983474,-27.4765584683701],[-58.8302580227853,-27.4773553861082],[-58.830220180239,-27.4775137635986],[-58.830242866431,-27.4776623234246],[-58.8303453042548,-27.4786578747261],[-58.8303819812923,-27.4790408148015],[-58.8316995035791,-27.4788881555491],[-58.8328811669856,-27.4787778708262],[-58.8327100603848,-27.4776073033441],[-58.8326123056799,-27.4768958762671],[-58.8339095724683,-27.4767434637465],[-58.8338028187825,-27.4760998189768]]]}"
154,393,482,875,317,331,7.77,113,"{""type"":""Polygon"",""coordinates"":[[[-58.8339095724683,-27.4767434637465],[-58.8326123056799,-27.4768958762671],[-58.8327100603848,-27.4776073033441],[-58.8328811669856,-27.4787778708262],[-58.8316995035791,-27.4788881555491],[-58.8303819812923,-27.4790408148015],[-58.8304472224934,-27.4796218566315],[-58.8305326164307,-27.4801981224435],[-58.8318757336056,-27.4800631678042],[-58.833011750554,-27.4799444606702],[-58.8330723549668,-27.4799391516016],[-58.834384826016,-27.4797865331943],[-58.834218683216,-27.478611392075],[-58.8340274117461,-27.4774456032779],[-58.8339095724683,-27.4767434637465]]]}"
156,493,575,1068,280,250,52.96,20,"{""type"":""Polygon"",""coordinates"":[[[-58.7831311967067,-27.4783009400454],[-58.7826271286491,-27.4784066373256],[-58.7822037484086,-27.4784977668594],[-58.7810754078438,-27.478782866088],[-58.7799728520305,-27.4790992030559],[-58.7793382446084,-27.4792652000895],[-58.7779706279668,-27.4794540931054],[-58.7775770001409,-27.4795087413006],[-58.7759274290242,-27.4797779010957],[-58.775014110734,-27.4799113474423],[-58.7739800058092,-27.4800824149638],[-58.7741328702672,-27.4807841717557],[-58.7741403845229,-27.4809374476349],[-58.7742667384723,-27.4815628562557],[-58.7743983677892,-27.4822017301911],[-58.7745520339169,-27.4829530961405],[-58.7746693639365,-27.4836462830769],[-58.7748160249716,-27.4842759427257],[-58.773812293308,-27.4844511338766],[-58.7738561460716,-27.4846625885934],[-58.7740050451069,-27.4854320593991],[-58.7749587938377,-27.4852935915462],[-58.7756146115802,-27.485185984625],[-58.776976957286,-27.4849791359444],[-58.7782681373351,-27.4847506288862],[-58.7789492325241,-27.4846426834324],[-58.7798676401903,-27.4845091450298],[-58.7806102858037,-27.4844545353338],[-58.7810941556831,-27.4843491029422],[-58.7814260988527,-27.48423208107],[-58.7817969720739,-27.4840198306848],[-58.7823683772622,-27.4836967490771],[-58.7825093895386,-27.4836588556007],[-58.7826156571024,-27.4836620053147],[-58.7827373859202,-27.4836830005527],[-58.7828237890989,-27.4837089591648],[-58.7829466076869,-27.4837976040146],[-58.7828512974904,-27.483532680966],[-58.7827972418715,-27.4833168494255],[-58.7828044500985,-27.4831363203696],[-58.7828125299765,-27.4830099111587],[-58.782885041562,-27.4828014799848],[-58.7832235467145,-27.4818363174123],[-58.7836739195098,-27.480594554411],[-58.7836680336355,-27.4802292454683],[-58.7835846258174,-27.4797611788709],[-58.7834613464485,-27.4793297104561],[-58.7831311967067,-27.4783009400454]]]}"
157,556,646,1202,292,312,29.9,40,"{""type"":""Polygon"",""coordinates"":[[[-58.7739800058092,-27.4800824149638],[-58.7730321513007,-27.480270419861],[-58.7718619390542,-27.4804702713475],[-58.7711654734828,-27.4805648442845],[-58.7704695835448,-27.4806954939429],[-58.7703031418835,-27.4807246768259],[-58.7700357803919,-27.4807686758836],[-58.7695415111575,-27.4808561581255],[-58.7687345832018,-27.4810017438169],[-58.7688996920815,-27.4818386799159],[-58.7689807222851,-27.4824782031533],[-58.769082341694,-27.4831400192134],[-58.7692048391059,-27.4838421681053],[-58.7693156383268,-27.4844452249114],[-58.7694272320379,-27.4850978917298],[-58.7696419777576,-27.4861913182248],[-58.770639738425,-27.4859575902993],[-58.7720626456402,-27.4857409966903],[-58.7734907479882,-27.48553334435],[-58.7740050451069,-27.4854320593991],[-58.7738561460716,-27.4846625885934],[-58.773812293308,-27.4844511338766],[-58.7748160249716,-27.4842759427257],[-58.7746693639365,-27.4836462830769],[-58.7745520339169,-27.4829530961405],[-58.7743983677892,-27.4822017301911],[-58.7742667384723,-27.4815628562557],[-58.7741403845229,-27.4809374476349],[-58.7741328702672,-27.4807841717557],[-58.7739800058092,-27.4800824149638]]]}"
158,573,599,1172,303,296,21.68,54,"{""type"":""Polygon"",""coordinates"":[[[-58.7687345832018,-27.4810017438169],[-58.7682304141024,-27.4811028801013],[-58.7669647500636,-27.4813445021376],[-58.7656338442931,-27.4816185171604],[-58.765079028396,-27.4817157737986],[-58.7648218474894,-27.4817641448004],[-58.7649177372327,-27.4823854390133],[-58.7650391285975,-27.4830199424668],[-58.7651559680618,-27.4836860800477],[-58.7652474523342,-27.4843480281132],[-58.765358518574,-27.4849691291377],[-58.7654752188184,-27.4856262460288],[-58.7658639631154,-27.4855807150413],[-58.7669690773955,-27.4854178260621],[-58.7667579431114,-27.4861332351604],[-58.7665003386325,-27.4871063573988],[-58.768060330521,-27.4866038746875],[-58.7684781940664,-27.4864812804114],[-58.7691981105504,-27.4862691371815],[-58.7696419777576,-27.4861913182248],[-58.7694272320379,-27.4850978917298],[-58.7693156383268,-27.4844452249114],[-58.7692048391059,-27.4838421681053],[-58.769082341694,-27.4831400192134],[-58.7689807222851,-27.4824782031533],[-58.7688996920815,-27.4818386799159],[-58.7687345832018,-27.4810017438169]]]}"
159,620,632,1252,321,339,36.26,35,"{""type"":""Polygon"",""coordinates"":[[[-58.7648218474894,-27.4817641448004],[-58.7636660527615,-27.4819186360203],[-58.7626019244719,-27.4821125553169],[-58.7617346520907,-27.482281419984],[-58.7607255681782,-27.4824385407258],[-58.7597481130308,-27.4826764514112],[-58.7598502514975,-27.4833743571326],[-58.7600283526535,-27.484396090316],[-58.7602142765311,-27.4852733737253],[-58.7604076280972,-27.4862994239894],[-58.760581472738,-27.4873708299998],[-58.760814863078,-27.489005350223],[-58.7619068909081,-27.4886532060895],[-58.7627420015117,-27.4883674616987],[-58.7636074504817,-27.4880813279136],[-58.7646284435297,-27.4877165304385],[-58.7654484397909,-27.4874354728454],[-58.7657405295247,-27.4873550807319],[-58.7665003386325,-27.4871063573988],[-58.7667579431114,-27.4861332351604],[-58.7669690773955,-27.4854178260621],[-58.7658639631154,-27.4855807150413],[-58.7654752188184,-27.4856262460288],[-58.765358518574,-27.4849691291377],[-58.7652474523342,-27.4843480281132],[-58.7651559680618,-27.4836860800477],[-58.7650391285975,-27.4830199424668],[-58.7649177372327,-27.4823854390133],[-58.7648218474894,-27.4817641448004]]]}"
160,513,512,1025,253,246,52.77,19,"{""type"":""Polygon"",""coordinates"":[[[-58.7696419777576,-27.4861913182248],[-58.7691981105504,-27.4862691371815],[-58.7684781940664,-27.4864812804114],[-58.768060330521,-27.4866038746875],[-58.7665003386325,-27.4871063573988],[-58.7657405295247,-27.4873550807319],[-58.7654484397909,-27.4874354728454],[-58.7646284435297,-27.4877165304385],[-58.7636074504817,-27.4880813279136],[-58.7627420015117,-27.4883674616987],[-58.7619068909081,-27.4886532060895],[-58.760814863078,-27.489005350223],[-58.7595112132082,-27.4894097825834],[-58.7597462802413,-27.4908322689095],[-58.7598995402183,-27.4918813807384],[-58.7599442312469,-27.4921469611883],[-58.7600768709936,-27.4928535016025],[-58.7607034840083,-27.4928139967048],[-58.7612593649317,-27.4927798953439],[-58.7614772629051,-27.4928042024894],[-58.7625622277795,-27.4926416011011],[-58.7634657710511,-27.4925218893734],[-58.7642835527969,-27.4924167921757],[-58.766282663117,-27.4921658813345],[-58.7681099580132,-27.4919261474168],[-58.7685591222249,-27.4918617966525],[-58.7693617927073,-27.4917613729071],[-58.7704923200479,-27.4916026418512],[-58.7703825215098,-27.4907469621516],[-58.7703267539043,-27.4904228846782],[-58.7701652320079,-27.48949568775],[-58.7700321807322,-27.4884508440163],[-58.7698321640599,-27.4873301657919],[-58.7696419777576,-27.4861913182248]]]}"
184,224,189,413,98,114,98.46,4,"{""type"":""Polygon"",""coordinates"":[[[-58.7550303907453,-27.5385363632735],[-58.7542102348505,-27.5391511818455],[-58.7535989691865,-27.5401738543978],[-58.7529819409984,-27.5414717636537],[-58.7518165752162,-27.5445719324593],[-58.7507758997063,-27.5494748911073],[-58.7503558325629,-27.552985171096],[-58.7500131342212,-27.5549923377343],[-58.7505908811006,-27.5553594650757],[-58.7519702811404,-27.5555315346173],[-58.7521099176015,-27.5528502875666],[-58.7522871422323,-27.5515804838495],[-58.7526463815832,-27.5502993620819],[-58.7531890617952,-27.5490971214822],[-58.7543807755612,-27.5473363533835],[-58.7557260724716,-27.5460066836952],[-58.7583804016278,-27.5436184217081],[-58.7625227933486,-27.53998427896],[-58.7676888039886,-27.5351912343016],[-58.7664409498302,-27.5356356356304],[-58.7648955205129,-27.5361424469532],[-58.7640010068492,-27.5365327196526],[-58.7633757330702,-27.5366714707611],[-58.7631487090272,-27.5367149491936],[-58.7627451822206,-27.5367967532904],[-58.7618461221506,-27.5369028824854],[-58.7610986262735,-27.5369935527304],[-58.7598549477437,-27.5370679481399],[-58.7587894955386,-27.5372122518906],[-58.7577960923807,-27.5374323219839],[-58.7568754542599,-27.5377732601862],[-58.756156758418,-27.5380845753129],[-58.7554776021733,-27.5383367454049],[-58.7550303907453,-27.5385363632735]]]}"
161,939,1029,1968,480,456,115.41,17,"{""type"":""Polygon"",""coordinates"":[[[-58.7829466076869,-27.4837976040146],[-58.7828237890989,-27.4837089591648],[-58.7827373859202,-27.4836830005527],[-58.7826156571024,-27.4836620053147],[-58.7825093895386,-27.4836588556007],[-58.7823683772622,-27.4836967490771],[-58.7817969720739,-27.4840198306848],[-58.7814260988527,-27.48423208107],[-58.7810941556831,-27.4843491029422],[-58.7806102858037,-27.4844545353338],[-58.7798676401903,-27.4845091450298],[-58.7789492325241,-27.4846426834324],[-58.7782681373351,-27.4847506288862],[-58.776976957286,-27.4849791359444],[-58.7756146115802,-27.485185984625],[-58.7749587938377,-27.4852935915462],[-58.7740050451069,-27.4854320593991],[-58.7734907479882,-27.48553334435],[-58.7720626456402,-27.4857409966903],[-58.770639738425,-27.4859575902993],[-58.7696419777576,-27.4861913182248],[-58.7698321640599,-27.4873301657919],[-58.7700321807322,-27.4884508440163],[-58.7701652320079,-27.48949568775],[-58.7703267539043,-27.4904228846782],[-58.7703825215098,-27.4907469621516],[-58.7704923200479,-27.4916026418512],[-58.7706330420602,-27.492494015213],[-58.7706688712447,-27.4928363898749],[-58.7709295220217,-27.4942675477189],[-58.7710133966929,-27.494767193055],[-58.7710816666748,-27.4952399713707],[-58.7711651820119,-27.4957170664427],[-58.7712489148121,-27.496207691421],[-58.771327374316,-27.4966848506558],[-58.7713986105687,-27.4970267739946],[-58.772382880209,-27.4968924427616],[-58.7735080347409,-27.4967111994526],[-58.7738160374012,-27.496675696186],[-58.7743408620596,-27.4965968287395],[-58.7745932313848,-27.496562033312],[-58.777258016987,-27.4961806753137],[-58.7778817481081,-27.4947021466252],[-58.7780281072242,-27.4943664682979],[-58.7785397775754,-27.4931555132193],[-58.7797036535122,-27.4903528834019],[-58.7805869342342,-27.4883477573036],[-58.7807526352978,-27.4879576978824],[-58.7813701330711,-27.4864115711818],[-58.7817667561755,-27.4855990389856],[-58.781806195642,-27.4855353811433],[-58.7819591865337,-27.4852988543866],[-58.7823309794615,-27.4848294684443],[-58.7826215953345,-27.4846588420217],[-58.7828314445604,-27.4844982716108],[-58.7829746086301,-27.4842799133928],[-58.7830130298561,-27.4841531154461],[-58.7830099059263,-27.4839591860391],[-58.7829466076869,-27.4837976040146]]]}"
162,620,701,1321,325,362,114.52,12,"{""type"":""Polygon"",""coordinates"":[[[-58.7704923200479,-27.4916026418512],[-58.7693617927073,-27.4917613729071],[-58.7685591222249,-27.4918617966525],[-58.7681099580132,-27.4919261474168],[-58.766282663117,-27.4921658813345],[-58.7642835527969,-27.4924167921757],[-58.764446829555,-27.4934567483251],[-58.7652849771349,-27.4981149342963],[-58.7653232592935,-27.498294885858],[-58.766097518682,-27.5021148392854],[-58.7703447180738,-27.5048215349574],[-58.7704163229065,-27.5048702437071],[-58.7722971440439,-27.5057484749927],[-58.7729491913411,-27.5063446279717],[-58.7731059118914,-27.5060223549645],[-58.7740913694801,-27.5037498190723],[-58.7742815346458,-27.503305323513],[-58.7751921666889,-27.5011013988356],[-58.7753863676547,-27.5005936975648],[-58.775606144905,-27.500103713262],[-58.7758098061159,-27.4995552924444],[-58.7760306658324,-27.4991329574933],[-58.7763072181495,-27.4983986577601],[-58.7767845351121,-27.4972512999707],[-58.777258016987,-27.4961806753137],[-58.7745932313848,-27.496562033312],[-58.7743408620596,-27.4965968287395],[-58.7738160374012,-27.496675696186],[-58.7735080347409,-27.4967111994526],[-58.772382880209,-27.4968924427616],[-58.7713986105687,-27.4970267739946],[-58.771327374316,-27.4966848506558],[-58.7712489148121,-27.496207691421],[-58.7711651820119,-27.4957170664427],[-58.7710816666748,-27.4952399713707],[-58.7710133966929,-27.494767193055],[-58.7709295220217,-27.4942675477189],[-58.7706688712447,-27.4928363898749],[-58.7706330420602,-27.492494015213],[-58.7704923200479,-27.4916026418512]]]}"
166,195,162,357,114,245,1355.42,0,"{""type"":""Polygon"",""coordinates"":[[[-58.7222260266344,-27.4542438086541],[-58.7214779778569,-27.4545913838985],[-58.7208698046945,-27.4548289623979],[-58.7190735047551,-27.4554060033937],[-58.7176180444502,-27.4557893552777],[-58.7164582125195,-27.4559976297689],[-58.7136500698895,-27.4565464708392],[-58.7125668253844,-27.4568033922412],[-58.7108587351159,-27.4572033144097],[-58.7095742145539,-27.4575258400905],[-58.7083594258565,-27.4577798331555],[-58.7077044496648,-27.4579367310324],[-58.7067600325316,-27.4580159750404],[-58.7057424700415,-27.4579427333307],[-58.7052754499887,-27.4578266550706],[-58.7047988046785,-27.4577422703305],[-58.7042353075489,-27.4576003033311],[-58.7037728607667,-27.4574525866543],[-58.7010601211296,-27.4566466956226],[-58.7000337754656,-27.4566592287954],[-58.6967885803054,-27.4567439180951],[-58.6935760345786,-27.4563183853748],[-58.6915245798447,-27.456424517627],[-58.6899381258819,-27.4565159555344],[-58.6894928618067,-27.456498802874],[-58.687758477008,-27.4565063004061],[-58.6857675422771,-27.4566025924304],[-58.6844224596331,-27.4566053352848],[-58.6830160885172,-27.4565682062108],[-58.6787049441173,-27.4567239964341],[-58.6785732131825,-27.4597119165932],[-58.6788206481604,-27.4670304044227],[-58.6788366577488,-27.4700887164611],[-58.6788419245208,-27.4707698242659],[-58.6804140983227,-27.470056151308],[-58.6804231156508,-27.4729837240243],[-58.6807080783806,-27.4784296475236],[-58.6818882870825,-27.4808739181673],[-58.6821317391335,-27.4815837230434],[-58.6823336865202,-27.483223306658],[-58.68215548209,-27.4838118980554],[-58.6830129786192,-27.4869818235834],[-58.6890268719364,-27.4856323332635],[-58.6900471861827,-27.4848756233508],[-58.694258418363,-27.4840710732822],[-58.6948346370393,-27.4830535842008],[-58.6968498468305,-27.481211079857],[-58.6982901853593,-27.4817934792637],[-58.7018568350553,-27.4805274212969],[-58.7033189944017,-27.4805546446438],[-58.7079941811647,-27.4862353680959],[-58.7087163630202,-27.4858340436477],[-58.7085204245993,-27.4846094520728],[-58.7086920636537,-27.4842599962035],[-58.7092752507735,-27.483702490105],[-58.7096734100602,-27.483282585477],[-58.7102651980002,-27.4829550317832],[-58.7108518555935,-27.4826230277238],[-58.711440043621,-27.4823902448536],[-58.71215936288,-27.4821332913014],[-58.7128323281286,-27.4818227724411],[-58.7141041092627,-27.4816402069359],[-58.714357238353,-27.4816551331288],[-58.7147626362146,-27.4817042709266],[-58.7149574571257,-27.4818732888682],[-58.7151082329718,-27.482137580582],[-58.7173236043362,-27.4824621200175],[-58.7187693922899,-27.4830622798004],[-58.7194048156768,-27.4832664479372],[-58.7198260810583,-27.4836852770739],[-58.7200723839585,-27.4842370865865],[-58.7203714436894,-27.484603292194],[-58.7210811925964,-27.4847072913086],[-58.722340129153,-27.4849984638364],[-58.7229041354176,-27.4854876922171],[-58.7236716274421,-27.4857262928651],[-58.724087017893,-27.4860910488932],[-58.724392698887,-27.4865564050508],[-58.7245494828911,-27.4878536291493],[-58.7285524233083,-27.4860311421508],[-58.7268914652397,-27.4797499026216],[-58.7232522389325,-27.4594278050048],[-58.722861920787,-27.4574162107081],[-58.7222260266344,-27.4542438086541]]]}"
197,669,806,1475,421,392,10.05,147,"{""type"":""Polygon"",""coordinates"":[[[-58.8278689772782,-27.4919433024693],[-58.8279635170935,-27.4924608079061],[-58.8280134277464,-27.4927262921502],[-58.8280191555281,-27.49276681452],[-58.8280860264428,-27.4931403362058],[-58.8281524507755,-27.4934867986128],[-58.8282019898869,-27.4937297333706],[-58.8282187265451,-27.4938242412169],[-58.8282852263574,-27.4941752133547],[-58.8283566348687,-27.494517099228],[-58.8284186001142,-27.4948997067531],[-58.8284801931823,-27.4952597648815],[-58.8285407431527,-27.4955566848315],[-58.8286013680395,-27.4958581145922],[-58.8286123772334,-27.4959121000219],[-58.828679029042,-27.4962720914784],[-58.8287345974513,-27.4965735875929],[-58.828795447254,-27.4968885467657],[-58.8293202211216,-27.4968094736615],[-58.8297439213792,-27.4967362388684],[-58.83060671594,-27.4966030954212],[-58.8304853800327,-27.4959957283676],[-58.8304619420498,-27.4958020705492],[-58.8304231083764,-27.4955950827573],[-58.8303677599024,-27.4953071170604],[-58.8303069814205,-27.4949966685448],[-58.8302635387831,-27.4948168063601],[-58.8300871588632,-27.4939395121887],[-58.8300234729595,-27.4934531787659],[-58.8299298175241,-27.4929897936726],[-58.8298248553096,-27.4924543836473],[-58.8296972046723,-27.4917704139401],[-58.829701366904,-27.4917162290568],[-58.8296953402872,-27.4916576673182],[-58.8295396876219,-27.4917273768596],[-58.8287926471231,-27.491822904227],[-58.8278689772782,-27.4919433024693]]]}"
198,416,465,881,244,268,4.11,214,"{""type"":""Polygon"",""coordinates"":[[[-58.8278689772782,-27.4919433024693],[-58.827071957496,-27.4920755640834],[-58.8268147123591,-27.4921195396247],[-58.8263506442044,-27.4921978057267],[-58.8262556000995,-27.4922622052244],[-58.8263220180554,-27.492608668852],[-58.8263555622057,-27.492802195067],[-58.8264003375838,-27.4930632365723],[-58.826472707242,-27.4934637521187],[-58.8264837895473,-27.4935222476686],[-58.8265444818809,-27.4938281886085],[-58.8265775057286,-27.4939901456018],[-58.8266103807722,-27.4941430828369],[-58.8266765034751,-27.4944715066143],[-58.8276347029036,-27.4942965317743],[-58.8282852263574,-27.4941752133547],[-58.8282187265451,-27.4938242412169],[-58.8282019898869,-27.4937297333706],[-58.8281524507755,-27.4934867986128],[-58.8280860264428,-27.4931403362058],[-58.8280191555281,-27.49276681452],[-58.8280134277464,-27.4927262921502],[-58.8279635170935,-27.4924608079061],[-58.8278689772782,-27.4919433024693]]]}"
167,305,302,607,151,185,1261.11,0,"{""type"":""Polygon"",""coordinates"":[[[-58.7656653479451,-27.4626586010341],[-58.7621944869596,-27.4600050186269],[-58.7609714378663,-27.4590957441955],[-58.7591592587487,-27.4577067176662],[-58.7581919804023,-27.4569791351777],[-58.7568923284283,-27.4585698664469],[-58.7566689425523,-27.458514042109],[-58.7558342128467,-27.4581727142747],[-58.7554212626236,-27.4579613940155],[-58.7544238270504,-27.4575634657548],[-58.7557081429762,-27.4550030908638],[-58.7539808397708,-27.4538565142008],[-58.7527485980898,-27.4529968986221],[-58.7520017851266,-27.4524559561379],[-58.7515826675829,-27.4521725252508],[-58.7510357387219,-27.4518004804014],[-58.7502640917298,-27.4512869060609],[-58.7495195800316,-27.4508902718751],[-58.7484997211248,-27.4509887878841],[-58.7475201618505,-27.4510777688603],[-58.7474825618702,-27.4512586800794],[-58.7462867482481,-27.451422541473],[-58.742976771124,-27.4518745045966],[-58.7418739267951,-27.4521634727793],[-58.7413049600311,-27.4526397310806],[-58.7407721832169,-27.4528448751777],[-58.7399967345527,-27.4530530494044],[-58.7394818397567,-27.4531091024103],[-58.7394667436648,-27.4531138019578],[-58.7388317159734,-27.4532480399376],[-58.7386178611768,-27.4534762597176],[-58.7387210645366,-27.4539305819661],[-58.7387966553809,-27.4542363859633],[-58.7393138916057,-27.4543291689274],[-58.7396501858754,-27.4544918752624],[-58.7397815340403,-27.4548060040677],[-58.7396595308385,-27.4550872098547],[-58.739722648433,-27.455564586792],[-58.73989232001,-27.4557429068106],[-58.7400758847111,-27.4558398551156],[-58.7400443892737,-27.4560883533075],[-58.7398032705334,-27.4561906077636],[-58.7394788225729,-27.4564608094988],[-58.7394627054396,-27.4567226484781],[-58.7395437104534,-27.4570509391629],[-58.7398592946056,-27.4571823263955],[-58.7400451279389,-27.45742359807],[-58.7401820327767,-27.4577692337338],[-58.7391887935158,-27.4579575710467],[-58.7381646493773,-27.4581101991814],[-58.7350453527351,-27.458482913846],[-58.732824219078,-27.4587316103186],[-58.7329281134421,-27.4582611732073],[-58.7330506308553,-27.4580115433582],[-58.7331933711582,-27.4577616617118],[-58.7331347941425,-27.4575729286769],[-58.7328682227477,-27.4573416739979],[-58.7326278483051,-27.4571687358627],[-58.7322266753179,-27.4570609516328],[-58.7321809614033,-27.4570479872584],[-58.7317963663213,-27.4570302156346],[-58.7315579673683,-27.4569835591322],[-58.7313446363089,-27.4569230575361],[-58.7312171134587,-27.4568524668619],[-58.7312031971322,-27.4566090455738],[-58.731205998323,-27.4564646585726],[-58.7311161748311,-27.4562176698832],[-58.7310591895592,-27.4554830842506],[-58.7308714063077,-27.4551155157808],[-58.7308044842825,-27.455039660412],[-58.7306500654466,-27.4548656502187],[-58.7304620175797,-27.4548048328962],[-58.7303894769563,-27.4546929590624],[-58.7301573362065,-27.4547229093326],[-58.7299714712496,-27.4548019054664],[-58.7298323747269,-27.4549615185923],[-58.7296028375343,-27.4551583429392],[-58.7295453359323,-27.4553620524706],[-58.7293343314088,-27.4554503820324],[-58.7293114454172,-27.4556040405248],[-58.7294299802446,-27.4557469208026],[-58.7294820160342,-27.4558410057509],[-58.7295388261479,-27.455916987348],[-58.7294740863956,-27.4559809454871],[-58.7294099800086,-27.4560854948072],[-58.7295180519866,-27.4562059498738],[-58.729612012678,-27.4563942452298],[-58.7297194516224,-27.4564741089113],[-58.7298126384985,-27.4566127926361],[-58.7297757119642,-27.4568388016928],[-58.7297694722922,-27.457086984599],[-58.7297735555141,-27.4573485722919],[-58.7297631752356,-27.4576554497056],[-58.7297272339845,-27.4579446005896],[-58.729680617622,-27.4581977960053],[-58.7296424936986,-27.4583471327675],[-58.7296198893645,-27.4585188317861],[-58.7295735541772,-27.4587900676968],[-58.7274431928068,-27.4590240183362],[-58.7232522389325,-27.4594278050048],[-58.7268914652397,-27.4797499026216],[-58.7285524233083,-27.4860311421508],[-58.7245494828911,-27.4878536291493],[-58.7232194937179,-27.4885242005015],[-58.7232775805739,-27.4893309496679],[-58.7232685188152,-27.4897235186339],[-58.7303140517261,-27.490326264445],[-58.7371751185473,-27.4920632088181],[-58.7370868365439,-27.4915951694546],[-58.7370093781042,-27.4911721046326],[-58.7369262258668,-27.4907085120034],[-58.7368103945339,-27.4900964649101],[-58.7366775525575,-27.4893673444953],[-58.7365513268209,-27.4887373827985],[-58.7364144221541,-27.4880714663085],[-58.736277519361,-27.4874055495466],[-58.7361132101838,-27.4866046450341],[-58.7360809570813,-27.4864832509325],[-58.7356212530354,-27.4845853508042],[-58.7369329770481,-27.484370501665],[-58.7382396382252,-27.484155703552],[-58.738971492455,-27.4840563407077],[-58.7399111797025,-27.4839859525923],[-58.7399263508006,-27.4839857629128],[-58.7414530772165,-27.4839350894424],[-58.7422770006065,-27.4842225009566],[-58.7429477251903,-27.4844170958426],[-58.7438299243873,-27.4845503949481],[-58.744509132483,-27.4846411234997],[-58.7452073608156,-27.4846549236793],[-58.7462139978456,-27.4846603397572],[-58.7478903724359,-27.4844768994679],[-58.7487692271931,-27.484398193666],[-58.7495111130724,-27.4842941385735],[-58.7508595535422,-27.4841644057252],[-58.7514653956705,-27.4840936285996],[-58.752061194257,-27.4840274862684],[-58.7530012963122,-27.4839840704847],[-58.753986767257,-27.4839310546377],[-58.7545321359334,-27.483874559309],[-58.7549150368923,-27.4837795121376],[-58.7563152957007,-27.4834099927166],[-58.7572770224047,-27.4831362166963],[-58.7575701104665,-27.4831189826347],[-58.7578072139188,-27.4830799003481],[-58.7588257062771,-27.4828775720385],[-58.7597481130308,-27.4826764514112],[-58.7607255681782,-27.4824385407258],[-58.7617346520907,-27.482281419984],[-58.7626019244719,-27.4821125553169],[-58.7636660527615,-27.4819186360203],[-58.7648218474894,-27.4817641448004],[-58.765079028396,-27.4817157737986],[-58.7635576711187,-27.4747972229299],[-58.7633891103266,-27.4743753291414],[-58.7634257132375,-27.4738155075753],[-58.7633457002895,-27.4735548860543],[-58.7624133965931,-27.4696331419532],[-58.7623954287901,-27.4694574421958],[-58.7626157531288,-27.4693193241246],[-58.7628823014005,-27.469225729925],[-58.763159494991,-27.4688478103124],[-58.7635346945142,-27.4685904444651],[-58.7638712377916,-27.4684463412695],[-58.7641210337398,-27.4682537160823],[-58.7653014302716,-27.463939815507],[-58.7656653479451,-27.4626586010341]]]}"
188,358,428,786,256,247,7.02,112,"{""type"":""Polygon"",""coordinates"":[[[-58.832518191549,-27.4852647378763],[-58.8313845470134,-27.4849187944037],[-58.8310692333495,-27.4848146834479],[-58.8311983399475,-27.4849753750597],[-58.8312267004988,-27.4854666841893],[-58.8312366248341,-27.4860664962142],[-58.8325285379634,-27.4865005731191],[-58.8331231821047,-27.4866731744749],[-58.8340333738672,-27.4869634072825],[-58.8340148651698,-27.4870674006001],[-58.8340779651852,-27.4875176530888],[-58.8353606307447,-27.4873924803499],[-58.8354564131176,-27.4873731735817],[-58.8366530322885,-27.4872446131755],[-58.8366884306851,-27.4872441459363],[-58.83666625706,-27.4871271568267],[-58.8366136348844,-27.4866993217564],[-58.8353866053246,-27.4868237719016],[-58.8353017025572,-27.4862790800561],[-58.8352368038371,-27.4857205917427],[-58.8351805802673,-27.4856852465151],[-58.8344484585463,-27.4857625626096],[-58.8339056564969,-27.4856659679157],[-58.832518191549,-27.4852647378763]]]}"
163,657,644,1301,304,399,1551.06,1,"{""type"":""Polygon"",""coordinates"":[[[-58.7341961495825,-27.4355550215163],[-58.7342881465144,-27.435941823581],[-58.740485792877,-27.4407228906835],[-58.7420865885183,-27.4418847637086],[-58.7432788214254,-27.4427855816732],[-58.7429708613273,-27.443136782014],[-58.7432121701578,-27.4440134068452],[-58.7436110919006,-27.4465526152984],[-58.7438509775352,-27.4476593166823],[-58.7440548780507,-27.4493709408797],[-58.7450597037044,-27.4492816681428],[-58.7458519862187,-27.4491815195608],[-58.747219803078,-27.449024527052],[-58.7481585457576,-27.4489135061489],[-58.7491174366387,-27.4487977149683],[-58.7503431216279,-27.4486063890113],[-58.7506628204705,-27.4483587779571],[-58.7519220523604,-27.4493308498902],[-58.7527351342352,-27.449907047658],[-58.7532622648657,-27.4503064011412],[-58.7536408639443,-27.450585826331],[-58.7544493365809,-27.4511891372587],[-58.7552427942132,-27.4518016543231],[-58.7567878612697,-27.4529369822804],[-58.7576168763475,-27.4535580581842],[-58.7578111348967,-27.4536909355054],[-58.7581638348097,-27.4539300756441],[-58.7593256338048,-27.4548085751558],[-58.7627599371036,-27.4574040592028],[-58.76395243029,-27.4583001724396],[-58.7648994610194,-27.4590234587177],[-58.7652123020515,-27.4586631276395],[-58.7671608265046,-27.4562295631303],[-58.7672348638458,-27.4561158496881],[-58.7688462160081,-27.4541060608392],[-58.7702440862252,-27.4523470709731],[-58.7712230120159,-27.4512700396748],[-58.7724949953315,-27.4498644841984],[-58.7747154022958,-27.4470619748689],[-58.7757270972924,-27.4458266135037],[-58.7766292193058,-27.4446963947755],[-58.7769398145521,-27.444200739548],[-58.7769671006175,-27.4433793987232],[-58.7769850036441,-27.442919053493],[-58.7779355712388,-27.4429204572599],[-58.7781195782915,-27.4430444151557],[-58.7783653955764,-27.4429239925394],[-58.7784586204691,-27.4427468754114],[-58.778537475696,-27.4426195621161],[-58.7786665193684,-27.4424690532276],[-58.7788200419748,-27.4422686112277],[-58.7788295008698,-27.4422278919162],[-58.7788669746335,-27.4420424645467],[-58.7789034353627,-27.4417938968373],[-58.7789216295022,-27.4416673579669],[-58.7789295689244,-27.4415319281507],[-58.7789071060852,-27.4413923756171],[-58.7789040673699,-27.4412029546097],[-58.779040180021,-27.4408628953421],[-58.7790497834547,-27.4408311960652],[-58.7790544042825,-27.4408040713667],[-58.7790489151985,-27.4407770757777],[-58.7790483363623,-27.4407409955859],[-58.7790377923318,-27.4407140645505],[-58.7790372135008,-27.4406779843581],[-58.7790418343274,-27.4406508596596],[-58.7790463827982,-27.4406192249369],[-58.7790457316129,-27.44057863472],[-58.779040170192,-27.4405471291052],[-58.7790396637177,-27.4405155589361],[-58.7790442121859,-27.4404839242131],[-58.7790538879459,-27.4404567349601],[-58.7790327999499,-27.4404028728844],[-58.7790121460867,-27.4403760709502],[-58.7790306293742,-27.4402675721554],[-58.7790099755386,-27.4402407702192],[-58.7789994315721,-27.4402138391763],[-58.7789838326828,-27.4401869726834],[-58.7789832538823,-27.4401508924872],[-58.7789928572831,-27.4401191932133],[-58.7789974781056,-27.4400920685148],[-58.7790020989261,-27.4400649438162],[-58.7789815174875,-27.4400426518974],[-58.7789709735494,-27.4400157208505],[-58.7789604296169,-27.4399887898023],[-58.7789448307717,-27.4399619233023],[-58.7789241770175,-27.4399351213485],[-58.7789287255049,-27.4399034866263],[-58.7789485110799,-27.4398761682824],[-58.7789581868196,-27.4398489790352],[-58.7789779000294,-27.439817150663],[-58.7789976855777,-27.4397898323131],[-58.7790072889492,-27.4397581330383],[-58.779022019573,-27.4397308792364],[-58.779046860002,-27.4397034963291],[-58.7790615906094,-27.4396762425236],[-58.779086575722,-27.4396578796591],[-58.779116688083,-27.4396439622606],[-58.7791313463114,-27.4396121984242],[-58.7791460768867,-27.4395849446109],[-58.7791608074551,-27.4395576907964],[-58.77916528351,-27.4395215460444],[-58.7791597221263,-27.4394900404288],[-58.7791642705354,-27.4394584057011],[-58.7791688912977,-27.4394312809978],[-58.7791784945946,-27.4393995817135],[-58.7791830429961,-27.4393679469852],[-58.7791875913955,-27.4393363122568],[-58.779202321924,-27.439309058439],[-58.7792069426729,-27.4392819337346],[-58.7792216731901,-27.4392546799151],[-58.7792466581837,-27.4392363170267],[-58.7792767704111,-27.4392223995991],[-58.7792914285441,-27.4391906357489],[-58.7792960492678,-27.4391635110424],[-58.7793057248691,-27.4391363217753],[-58.7793052183498,-27.4391047516045],[-58.7792895472014,-27.4390733751134],[-58.7792488187581,-27.4390558514869],[-58.7792231825965,-27.4390336241522],[-58.7792075838376,-27.4390067576747],[-58.7792119875101,-27.4389661028955],[-58.7792318452157,-27.4389432945439],[-58.779241520817,-27.4389161052807],[-58.7792561065679,-27.4388798314095],[-58.7792554553542,-27.4388392411872],[-58.7792803678942,-27.4388163682718],[-58.779305352783,-27.4387980053769],[-58.7793150283554,-27.4387708161095],[-58.7792893922506,-27.4387485887837],[-58.7792588460088,-27.4387354460601],[-58.7792233172684,-27.438726877911],[-58.7791926263316,-27.4387047151223],[-58.7791720451252,-27.4386824232173],[-58.7791765935113,-27.4386507884875],[-58.7792012889661,-27.4386143855118],[-58.7792209295509,-27.4385780470886],[-58.7792254055656,-27.4385419023326],[-58.779214861734,-27.4385149712946],[-58.7791942082074,-27.4384881693658],[-58.7791835920361,-27.4384567282995],[-58.7791932676141,-27.4384295390393],[-58.7792232349271,-27.4384066015817],[-58.779237820627,-27.4383703277128],[-58.7792625883598,-27.4383384347539],[-58.7793377597774,-27.4382968761524],[-58.7793734331053,-27.4383144643285],[-58.7794039068788,-27.4383230970079],[-58.7794337293929,-27.4382911394589],[-58.7794637689811,-27.4382727119778],[-58.7794939532889,-27.4382633045397],[-58.7795243546897,-27.4382674271686],[-58.7795596661965,-27.4382624651743],[-58.7795950500686,-27.4382620131955],[-58.7796251619905,-27.4382480957054],[-58.7796602563703,-27.4382296036138],[-58.779680113857,-27.4382067952066],[-58.7796948441278,-27.4381795413454],[-58.779709429645,-27.4381432674348],[-58.7797191050691,-27.4381160781444],[-58.7797287804888,-27.4380888888534],[-58.779748493188,-27.4380570603899],[-58.779773405455,-27.4380341873969],[-58.7797983900882,-27.4380158244239],[-58.7798181027552,-27.4379839959518],[-58.779837960167,-27.437961187525],[-58.779852690369,-27.4379339336496],[-58.7798673481851,-27.4379021697491],[-58.779887133193,-27.4378748512924],[-58.7799173173531,-27.4378654437688],[-58.7799429533621,-27.4378876709854],[-58.7799781923405,-27.4378781988679],[-58.7800080145696,-27.4378462412074],[-58.7800124179263,-27.4378055864126],[-58.7800018016037,-27.4377741454137],[-58.7799912576711,-27.4377472144371],[-58.779980713744,-27.4377202834595],[-58.7799752246342,-27.4376932878992],[-58.7799545710955,-27.4376664860816],[-58.7799490819954,-27.4376394905196],[-58.7799183912371,-27.4376173278802],[-58.7798927552985,-27.437595100655],[-58.7798671193702,-27.4375728734245],[-58.7798565754918,-27.4375459424346],[-58.7798662508358,-27.4375187531359],[-58.7798911629629,-27.4374958801272],[-58.7799161474594,-27.4374775171384],[-58.7799411319475,-27.4374591541454],[-58.7799406252835,-27.4374275839779],[-58.7799200441858,-27.4374052921755],[-58.7798993907177,-27.4373784903455],[-58.7798988840674,-27.4373469201768],[-58.7798933950012,-27.4373199246101],[-58.7798980155259,-27.4372927998874],[-58.7799025636701,-27.4372611651404],[-58.7799071841909,-27.4372340404174],[-58.77990169513,-27.4372070448504],[-58.7798860964947,-27.4371801784378],[-58.7798805350652,-27.4371486728451],[-58.7798902103744,-27.4371214835452],[-58.7799151947903,-27.4371031205596],[-58.7799452339821,-27.4370846929909],[-58.7799649464561,-27.4370528645038],[-58.7799746217373,-27.437025675199],[-58.7799893517942,-27.4369984213132],[-58.780014191402,-27.4369710382635],[-58.7800390309976,-27.4369436552099],[-58.780063942965,-27.4369207821764],[-58.7800939820826,-27.4369023545786],[-58.7801189664154,-27.4368839915598],[-58.7801439507399,-27.436865628537],[-58.7801637355076,-27.4368383100492],[-58.7801732659475,-27.4368021006855],[-58.7801929059199,-27.4367657621466],[-58.7802178902059,-27.4367473991121],[-58.7802428744834,-27.4367290360734],[-58.7802779682852,-27.4367105438501],[-58.7803080073096,-27.43669211621],[-58.780322737243,-27.4366648622937],[-58.7803373947754,-27.4366330983526],[-58.780362234217,-27.4366057152475],[-58.7803921284064,-27.4365782675442],[-58.7804221673758,-27.4365598398818],[-58.780452206335,-27.4365414122133],[-58.7804971923544,-27.436509260676],[-58.7805577770281,-27.4365039754641],[-58.7805930155118,-27.4364945032126],[-58.780623199234,-27.4364850955551],[-58.7806938209864,-27.4364751710569],[-58.7807240771029,-27.4364702734008],[-58.7807593155594,-27.4364608011083],[-58.7807944815972,-27.4364468187848],[-58.7808245928735,-27.4364329010626],[-58.780859903723,-27.436427938768],[-58.7808901598173,-27.4364230410767],[-58.7807096954937,-27.4362043112699],[-58.7806921418333,-27.4360556743271],[-58.7806683750183,-27.4358349416093],[-58.7812315194223,-27.4353270278942],[-58.7806932322287,-27.434549003474],[-58.7800197462959,-27.4329066013239],[-58.7792085885864,-27.4315050333559],[-58.778720034404,-27.4316195336529],[-58.7776472987378,-27.4302979804798],[-58.7765674403643,-27.4288456909354],[-58.7754680429994,-27.4274342393444],[-58.7724583089768,-27.4276394586358],[-58.7707586228981,-27.4285226615395],[-58.7679924393531,-27.4281517971863],[-58.7660734719623,-27.4276483464232],[-58.7638734470103,-27.4269544542651],[-58.7619374719003,-27.4253775468746],[-58.7604630096662,-27.4232534632379],[-58.7589428624941,-27.420475844744],[-58.7588508274639,-27.4194530117665],[-58.7578807395724,-27.4182066834451],[-58.7561225340055,-27.4166680421625],[-58.7558439647808,-27.4156746215181],[-58.7549663629619,-27.4126001508845],[-58.7551251268197,-27.4111320775885],[-58.7549868166816,-27.4106962518514],[-58.7536431716453,-27.409472634332],[-58.7523512300465,-27.4086408101834],[-58.7512745394235,-27.4083160134087],[-58.7500451040847,-27.4082412308732],[-58.749352510593,-27.4072710337839],[-58.748088022539,-27.4065741537537],[-58.7474142513623,-27.4055134896256],[-58.7457589812796,-27.4047132196588],[-58.7450746899476,-27.4039458906459],[-58.7438021089791,-27.4046610194206],[-58.7329370890012,-27.4200076678502],[-58.732874156601,-27.422128631612],[-58.7329719933517,-27.4245092351147],[-58.7327746458973,-27.4309714700359],[-58.7339369489803,-27.4344981591032],[-58.7341961495825,-27.4355550215163]]]}"
164,91,40,131,23,33,2684.08,0,"{""type"":""Polygon"",""coordinates"":[[[-58.7450746899476,-27.4039458906459],[-58.7438377156469,-27.4017780327033],[-58.7427194847991,-27.4013769984676],[-58.741564252848,-27.3995825105661],[-58.740003958456,-27.3983840105652],[-58.7399562688191,-27.3966298156345],[-58.7396170945943,-27.3953032931416],[-58.739388609707,-27.3932987342279],[-58.7372197369457,-27.3916341276859],[-58.7352501342859,-27.3907519266922],[-58.7338943246958,-27.3896906485855],[-58.7320389941903,-27.3873814892906],[-58.7308356734656,-27.3860476222256],[-58.730722746655,-27.3846370652797],[-58.7286846192184,-27.3835616395661],[-58.72640968602,-27.3828545086768],[-58.7247630600615,-27.3816027573907],[-58.7227628841256,-27.3813387627146],[-58.720827812642,-27.3813626441003],[-58.7186795562875,-27.3806718653473],[-58.7164717888091,-27.3790705483098],[-58.7143529386748,-27.3773327690756],[-58.7131396938507,-27.375989836355],[-58.7104581699683,-27.3744573879862],[-58.7064624210809,-27.3725620314243],[-58.7035263679914,-27.3718851520445],[-58.694285598224,-27.3838979403514],[-58.6805430863776,-27.401147745154],[-58.6801514388772,-27.4016531974078],[-58.6785299747751,-27.4037252790089],[-58.6708184153122,-27.4135709267896],[-58.6740772968772,-27.4144746518975],[-58.6967117392015,-27.4206563494203],[-58.7122684305322,-27.4253651085749],[-58.7136188989922,-27.4257364599301],[-58.7227711706916,-27.4284700850929],[-58.7234224960327,-27.4287417155109],[-58.7237935808385,-27.4288724566329],[-58.725897323453,-27.4295636708851],[-58.7278465105726,-27.4310416873268],[-58.7293078177042,-27.4320295177888],[-58.7341961495825,-27.4355550215163],[-58.7339369489803,-27.4344981591032],[-58.7327746458973,-27.4309714700359],[-58.7329719933517,-27.4245092351147],[-58.732874156601,-27.422128631612],[-58.7329370890012,-27.4200076678502],[-58.7438021089791,-27.4046610194206],[-58.7450746899476,-27.4039458906459]]]}"
165,292,311,603,154,192,2380.8,0,"{""type"":""Polygon"",""coordinates"":[[[-58.663039505011,-27.4227222712255],[-58.6686213352625,-27.4217623568465],[-58.6704839206645,-27.4303066356943],[-58.6724565504074,-27.4407622539491],[-58.6755637053486,-27.4563287634155],[-58.6756895397009,-27.4569588006378],[-58.6787049441173,-27.4567239964341],[-58.6830160885172,-27.4565682062108],[-58.6844224596331,-27.4566053352848],[-58.6857675422771,-27.4566025924304],[-58.687758477008,-27.4565063004061],[-58.6894928618067,-27.456498802874],[-58.6899381258819,-27.4565159555344],[-58.6915245798447,-27.456424517627],[-58.6935760345786,-27.4563183853748],[-58.6967885803054,-27.4567439180951],[-58.7000337754656,-27.4566592287954],[-58.7010601211296,-27.4566466956226],[-58.7037728607667,-27.4574525866543],[-58.7042353075489,-27.4576003033311],[-58.7047988046785,-27.4577422703305],[-58.7052754499887,-27.4578266550706],[-58.7057424700415,-27.4579427333307],[-58.7067600325316,-27.4580159750404],[-58.7077044496648,-27.4579367310324],[-58.7083594258565,-27.4577798331555],[-58.7095742145539,-27.4575258400905],[-58.7108587351159,-27.4572033144097],[-58.7125668253844,-27.4568033922412],[-58.7136500698895,-27.4565464708392],[-58.7164582125195,-27.4559976297689],[-58.7176180444502,-27.4557893552777],[-58.7190735047551,-27.4554060033937],[-58.7208698046945,-27.4548289623979],[-58.7214779778569,-27.4545913838985],[-58.7222260266344,-27.4542438086541],[-58.7220560547493,-27.4533933277806],[-58.7220472150478,-27.4531498420006],[-58.7223985188811,-27.4529785899988],[-58.7228768439428,-27.4528463650269],[-58.7259824168936,-27.4522485462618],[-58.727364423411,-27.4520239057441],[-58.728700571507,-27.4517772658356],[-58.73122919494,-27.4514751964247],[-58.7323395877989,-27.4513441032524],[-58.7342613106892,-27.4510359937828],[-58.7346144223804,-27.4509819753457],[-58.7368181800697,-27.4506026530863],[-58.7389859662163,-27.4501876575564],[-58.7414210363647,-27.4497286882104],[-58.7440548780507,-27.4493709408797],[-58.7438509775352,-27.4476593166823],[-58.7436110919006,-27.4465526152984],[-58.7432121701578,-27.4440134068452],[-58.7429708613273,-27.443136782014],[-58.7432788214254,-27.4427855816732],[-58.7420865885183,-27.4418847637086],[-58.740485792877,-27.4407228906835],[-58.7342881465144,-27.435941823581],[-58.7341961495825,-27.4355550215163],[-58.7293078177042,-27.4320295177888],[-58.7278465105726,-27.4310416873268],[-58.725897323453,-27.4295636708851],[-58.7237935808385,-27.4288724566329],[-58.7234224960327,-27.4287417155109],[-58.7227711706916,-27.4284700850929],[-58.7136188989922,-27.4257364599301],[-58.7122684305322,-27.4253651085749],[-58.6967117392015,-27.4206563494203],[-58.6740772968772,-27.4144746518975],[-58.6708184153122,-27.4135709267896],[-58.663039505011,-27.4227222712255]]]}"
199,419,477,896,231,264,5.04,178,"{""type"":""Polygon"",""coordinates"":[[[-58.8282852263574,-27.4941752133547],[-58.8276347029036,-27.4942965317743],[-58.8266765034751,-27.4944715066143],[-58.8268257838734,-27.4952409014963],[-58.8268921314859,-27.4955828546674],[-58.8269415946009,-27.4958212800247],[-58.8269474711754,-27.4958708221711],[-58.8270093581488,-27.4962489205852],[-58.827070947687,-27.4966089794585],[-58.8271268099254,-27.4969285158789],[-58.8271718873358,-27.4972075962898],[-58.8280853380148,-27.4970783137714],[-58.8285194532829,-27.4970229891638],[-58.8287565538661,-27.4969837857711],[-58.828795447254,-27.4968885467657],[-58.8287345974513,-27.4965735875929],[-58.828679029042,-27.4962720914784],[-58.8286123772334,-27.4959121000219],[-58.8286013680395,-27.4958581145922],[-58.8285407431527,-27.4955566848315],[-58.8284801931823,-27.4952597648815],[-58.8284186001142,-27.4948997067531],[-58.8283566348687,-27.494517099228],[-58.8282852263574,-27.4941752133547]]]}"
200,445,494,939,246,248,5.38,175,"{""type"":""Polygon"",""coordinates"":[[[-58.8319095351917,-27.4937170512565],[-58.8314299201041,-27.4937729849174],[-58.8305517531622,-27.493892802438],[-58.8300871588632,-27.4939395121887],[-58.8302635387831,-27.4948168063601],[-58.8303069814205,-27.4949966685448],[-58.8303677599024,-27.4953071170604],[-58.8304231083764,-27.4955950827573],[-58.8304619420498,-27.4958020705492],[-58.8304853800327,-27.4959957283676],[-58.83060671594,-27.4966030954212],[-58.831086045216,-27.496529124569],[-58.8319538187121,-27.4963913964945],[-58.8323318496874,-27.4963097336318],[-58.8324473467872,-27.4962585931259],[-58.8322626247165,-27.4954896726114],[-58.8321633776554,-27.4949947873036],[-58.8320803489298,-27.494562840054],[-58.8319095351917,-27.4937170512565]]]}"
168,695,701,1396,356,347,137.25,10,"{""type"":""Polygon"",""coordinates"":[[[-58.7462139978456,-27.4846603397572],[-58.7452073608156,-27.4846549236793],[-58.744509132483,-27.4846411234997],[-58.7438299243873,-27.4845503949481],[-58.7429477251903,-27.4844170958426],[-58.7422770006065,-27.4842225009566],[-58.7414530772165,-27.4839350894424],[-58.7399263508006,-27.4839857629128],[-58.7399111797025,-27.4839859525923],[-58.738971492455,-27.4840563407077],[-58.7382396382252,-27.484155703552],[-58.7369329770481,-27.484370501665],[-58.7356212530354,-27.4845853508042],[-58.7360809570813,-27.4864832509325],[-58.7361132101838,-27.4866046450341],[-58.736277519361,-27.4874055495466],[-58.7364144221541,-27.4880714663085],[-58.7365513268209,-27.4887373827985],[-58.7366775525575,-27.4893673444953],[-58.7368103945339,-27.4900964649101],[-58.7369262258668,-27.4907085120034],[-58.7370093781042,-27.4911721046326],[-58.7370868365439,-27.4915951694546],[-58.7371751185473,-27.4920632088181],[-58.7382414959582,-27.4923250600297],[-58.7386376044679,-27.4924238632229],[-58.7393783983663,-27.492567977342],[-58.7394950027753,-27.4925845634644],[-58.7401032414776,-27.4926626662445],[-58.7404425148045,-27.4926854884843],[-58.7410349435078,-27.4927231861765],[-58.741125977224,-27.4927220470074],[-58.7419603817034,-27.492707091771],[-58.7426323088536,-27.4926535679162],[-58.7431782260503,-27.4926286854459],[-58.7433293090735,-27.4925861937721],[-58.7433495976554,-27.492910729216],[-58.7435423255801,-27.4935849592224],[-58.7436340483941,-27.4942694766421],[-58.7439561337121,-27.4951270341291],[-58.7471790601669,-27.4948475160978],[-58.7488696177143,-27.4945917055895],[-58.7491294036783,-27.4947057246775],[-58.7491792656159,-27.4946599882118],[-58.749376222675,-27.4946394679891],[-58.7495886374029,-27.494636796934],[-58.7497103025351,-27.4946533107133],[-58.7497965652389,-27.4946702696454],[-58.749938888415,-27.4947135891477],[-58.750127299911,-27.4947924164],[-58.7503446296421,-27.4947806604389],[-58.7505416579612,-27.4947646486246],[-58.7507452424267,-27.4948432841077],[-58.7510328060731,-27.4947945555931],[-58.7511898026136,-27.4948061124254],[-58.7512813372776,-27.4948365369307],[-58.7515860723526,-27.4949138978645],[-58.7517094517724,-27.495038651199],[-58.7517812566044,-27.4951009004578],[-58.7517720111986,-27.4954754260763],[-58.7520805202281,-27.4954715411608],[-58.752585629598,-27.4954245804909],[-58.7529596002703,-27.4954018251656],[-58.7531700149394,-27.4952728671251],[-58.753259763672,-27.4951905389928],[-58.7534248744913,-27.4950756843572],[-58.7537425677564,-27.4950130376685],[-58.7539247092115,-27.4950152525216],[-58.7542018704852,-27.4949486048182],[-58.7544946329936,-27.4949088255334],[-58.7546672314749,-27.4949472473671],[-58.7549495926148,-27.4948895545118],[-58.7551707627475,-27.4948010564237],[-58.7557000809659,-27.4946861149284],[-58.7555224499446,-27.4940117139777],[-58.7554365933828,-27.4937015417343],[-58.7552006651464,-27.4925406929965],[-58.7548686829595,-27.4907450107254],[-58.7537640642673,-27.4909438871982],[-58.7532140318061,-27.4910275051596],[-58.7526035962327,-27.4911299256496],[-58.7519730014596,-27.4912371082898],[-58.7513626346543,-27.4913440334962],[-58.7510800660452,-27.4913881885834],[-58.7508127405685,-27.4914366622533],[-58.7499347596206,-27.491574014238],[-58.7495160689453,-27.4916469438878],[-58.7491780815401,-27.4917053248657],[-58.7484160590066,-27.491818654748],[-58.7479670931586,-27.4918964711969],[-58.7474277421237,-27.4888132361986],[-58.7474295245553,-27.4882854309931],[-58.7469952452941,-27.4883314826834],[-58.7462139978456,-27.4846603397572]]]}"
169,643,695,1338,312,319,66.96,20,"{""type"":""Polygon"",""coordinates"":[[[-58.7549150368923,-27.4837795121376],[-58.7545321359334,-27.483874559309],[-58.753986767257,-27.4839310546377],[-58.7530012963122,-27.4839840704847],[-58.752061194257,-27.4840274862684],[-58.7514653956705,-27.4840936285996],[-58.7508595535422,-27.4841644057252],[-58.7495111130724,-27.4842941385735],[-58.7487692271931,-27.484398193666],[-58.7478903724359,-27.4844768994679],[-58.7462139978456,-27.4846603397572],[-58.7469952452941,-27.4883314826834],[-58.7474295245553,-27.4882854309931],[-58.7474277421237,-27.4888132361986],[-58.7479670931586,-27.4918964711969],[-58.7484160590066,-27.491818654748],[-58.7491780815401,-27.4917053248657],[-58.7495160689453,-27.4916469438878],[-58.7499347596206,-27.491574014238],[-58.7508127405685,-27.4914366622533],[-58.7510800660452,-27.4913881885834],[-58.7513626346543,-27.4913440334962],[-58.7519730014596,-27.4912371082898],[-58.7526035962327,-27.4911299256496],[-58.7532140318061,-27.4910275051596],[-58.7537640642673,-27.4909438871982],[-58.7548686829595,-27.4907450107254],[-58.7556202886691,-27.4906137335538],[-58.7562602741948,-27.4904613065575],[-58.7560842932937,-27.4889343151266],[-58.7559932874535,-27.4882994193522],[-58.7557915724206,-27.4883380523905],[-58.7553251370757,-27.4857185618212],[-58.7552818195189,-27.4855386700188],[-58.7552396464772,-27.4854309390422],[-58.7552164858736,-27.4852462820028],[-58.7551247946943,-27.4848865620296],[-58.7549150368923,-27.4837795121376]]]}"
170,465,521,986,231,231,62.24,16,"{""type"":""Polygon"",""coordinates"":[[[-58.7597481130308,-27.4826764514112],[-58.7588257062771,-27.4828775720385],[-58.7578072139188,-27.4830799003481],[-58.7575701104665,-27.4831189826347],[-58.7572770224047,-27.4831362166963],[-58.7563152957007,-27.4834099927166],[-58.7549150368923,-27.4837795121376],[-58.7551247946943,-27.4848865620296],[-58.7552164858736,-27.4852462820028],[-58.7552396464772,-27.4854309390422],[-58.7552818195189,-27.4855386700188],[-58.7553251370757,-27.4857185618212],[-58.7557915724206,-27.4883380523905],[-58.7559932874535,-27.4882994193522],[-58.7560842932937,-27.4889343151266],[-58.7562602741948,-27.4904613065575],[-58.7556202886691,-27.4906137335538],[-58.7548686829595,-27.4907450107254],[-58.7552006651464,-27.4925406929965],[-58.7554365933828,-27.4937015417343],[-58.7555224499446,-27.4940117139777],[-58.7557000809659,-27.4946861149284],[-58.7560133582938,-27.4946641173927],[-58.7561739089545,-27.4945808938043],[-58.7561991247286,-27.4945760645591],[-58.7593836449872,-27.4941118011308],[-58.7614380736738,-27.4938377043464],[-58.7616349541719,-27.4938126569028],[-58.7627404456096,-27.4936678376677],[-58.7636036814721,-27.4935576573341],[-58.764446829555,-27.4934567483251],[-58.7642835527969,-27.4924167921757],[-58.7634657710511,-27.4925218893734],[-58.7625622277795,-27.4926416011011],[-58.7614772629051,-27.4928042024894],[-58.7612593649317,-27.4927798953439],[-58.7607034840083,-27.4928139967048],[-58.7600768709936,-27.4928535016025],[-58.7599442312469,-27.4921469611883],[-58.7598995402183,-27.4918813807384],[-58.7597462802413,-27.4908322689095],[-58.7595112132082,-27.4894097825834],[-58.760814863078,-27.489005350223],[-58.760581472738,-27.4873708299998],[-58.7604076280972,-27.4862994239894],[-58.7602142765311,-27.4852733737253],[-58.7600283526535,-27.484396090316],[-58.7598502514975,-27.4833743571326],[-58.7597481130308,-27.4826764514112]]]}"
171,598,577,1175,268,290,289.14,4,"{""type"":""Polygon"",""coordinates"":[[[-58.7663580569944,-27.4601146588759],[-58.7656653479451,-27.4626586010341],[-58.7653014302716,-27.463939815507],[-58.7641210337398,-27.4682537160823],[-58.7638712377916,-27.4684463412695],[-58.7635346945142,-27.4685904444651],[-58.763159494991,-27.4688478103124],[-58.7628823014005,-27.469225729925],[-58.7626157531288,-27.4693193241246],[-58.7623954287901,-27.4694574421958],[-58.7624133965931,-27.4696331419532],[-58.7633457002895,-27.4735548860543],[-58.7634257132375,-27.4738155075753],[-58.7633891103266,-27.4743753291414],[-58.7635576711187,-27.4747972229299],[-58.765079028396,-27.4817157737986],[-58.7656338442931,-27.4816185171604],[-58.7669647500636,-27.4813445021376],[-58.7682304141024,-27.4811028801013],[-58.7687345832018,-27.4810017438169],[-58.7695415111575,-27.4808561581255],[-58.7700357803919,-27.4807686758836],[-58.7703031418835,-27.4807246768259],[-58.7704695835448,-27.4806954939429],[-58.7711654734828,-27.4805648442845],[-58.7718619390542,-27.4804702713475],[-58.7730321513007,-27.480270419861],[-58.7739800058092,-27.4800824149638],[-58.775014110734,-27.4799113474423],[-58.7759274290242,-27.4797779010957],[-58.7775770001409,-27.4795087413006],[-58.7779706279668,-27.4794540931054],[-58.7793382446084,-27.4792652000895],[-58.7799728520305,-27.4790992030559],[-58.7810754078438,-27.478782866088],[-58.7822037484086,-27.4784977668594],[-58.7826271286491,-27.4784066373256],[-58.7831311967067,-27.4783009400454],[-58.7827861016586,-27.4772858926965],[-58.7825413719598,-27.4765357032279],[-58.7824417394692,-27.4763159439761],[-58.781430926857,-27.4732163467745],[-58.7810767685036,-27.4722645623812],[-58.7805465147808,-27.4713691604159],[-58.7798030353347,-27.4704223511815],[-58.7786182977659,-27.4693954681139],[-58.7783520411036,-27.4691913667782],[-58.7757816958864,-27.4672213219213],[-58.7742203479448,-27.4660413187405],[-58.7727054758438,-27.4649193472064],[-58.770718991908,-27.463397371477],[-58.7703044103381,-27.4630868771089],[-58.7692091747223,-27.4622707837583],[-58.7683903584558,-27.461663185459],[-58.7676070144142,-27.4610596426291],[-58.7675404961321,-27.4610108665653],[-58.7663580569944,-27.4601146588759]]]}"
201,357,409,766,199,209,4.67,164,"{""type"":""Polygon"",""coordinates"":[[[-58.8335957318354,-27.4935189156973],[-58.8330807183188,-27.493575321521],[-58.8324043213516,-27.4936609161424],[-58.8319095351917,-27.4937170512565],[-58.8320803489298,-27.494562840054],[-58.8321633776554,-27.4949947873036],[-58.8322626247165,-27.4954896726114],[-58.8324473467872,-27.4962585931259],[-58.8329064436315,-27.4961848825861],[-58.833597504122,-27.4960675158825],[-58.8340413524517,-27.4959894917866],[-58.8339074918852,-27.4952379466398],[-58.8338129213308,-27.4947204469137],[-58.8337789896995,-27.4945043739499],[-58.8337398514855,-27.4942793479166],[-58.8335957318354,-27.4935189156973]]]}"
172,375,413,788,217,278,213.25,4,"{""type"":""Polygon"",""coordinates"":[[[-58.7440548780507,-27.4493709408797],[-58.7414210363647,-27.4497286882104],[-58.7389859662163,-27.4501876575564],[-58.7368181800697,-27.4506026530863],[-58.7346144223804,-27.4509819753457],[-58.7342613106892,-27.4510359937828],[-58.7323395877989,-27.4513441032524],[-58.73122919494,-27.4514751964247],[-58.728700571507,-27.4517772658356],[-58.727364423411,-27.4520239057441],[-58.7259824168936,-27.4522485462618],[-58.7228768439428,-27.4528463650269],[-58.7223985188811,-27.4529785899988],[-58.7220472150478,-27.4531498420006],[-58.7220560547493,-27.4533933277806],[-58.7222260266344,-27.4542438086541],[-58.722861920787,-27.4574162107081],[-58.7232522389325,-27.4594278050048],[-58.7274431928068,-27.4590240183362],[-58.7295735541772,-27.4587900676968],[-58.7296198893645,-27.4585188317861],[-58.7296424936986,-27.4583471327675],[-58.729680617622,-27.4581977960053],[-58.7297272339845,-27.4579446005896],[-58.7297631752356,-27.4576554497056],[-58.7297735555141,-27.4573485722919],[-58.7297694722922,-27.457086984599],[-58.7297757119642,-27.4568388016928],[-58.7298126384985,-27.4566127926361],[-58.7297194516224,-27.4564741089113],[-58.729612012678,-27.4563942452298],[-58.7295180519866,-27.4562059498738],[-58.7294099800086,-27.4560854948072],[-58.7294740863956,-27.4559809454871],[-58.7295388261479,-27.455916987348],[-58.7294820160342,-27.4558410057509],[-58.7294299802446,-27.4557469208026],[-58.7293114454172,-27.4556040405248],[-58.7293343314088,-27.4554503820324],[-58.7295453359323,-27.4553620524706],[-58.7296028375343,-27.4551583429392],[-58.7298323747269,-27.4549615185923],[-58.7299714712496,-27.4548019054664],[-58.7301573362065,-27.4547229093326],[-58.7303894769563,-27.4546929590624],[-58.7304620175797,-27.4548048328962],[-58.7306500654466,-27.4548656502187],[-58.7308044842825,-27.455039660412],[-58.7308714063077,-27.4551155157808],[-58.7310591895592,-27.4554830842506],[-58.7311161748311,-27.4562176698832],[-58.731205998323,-27.4564646585726],[-58.7312031971322,-27.4566090455738],[-58.7312171134587,-27.4568524668619],[-58.7313446363089,-27.4569230575361],[-58.7315579673683,-27.4569835591322],[-58.7317963663213,-27.4570302156346],[-58.7321809614033,-27.4570479872584],[-58.7322266753179,-27.4570609516328],[-58.7326278483051,-27.4571687358627],[-58.7328682227477,-27.4573416739979],[-58.7331347941425,-27.4575729286769],[-58.7331933711582,-27.4577616617118],[-58.7330506308553,-27.4580115433582],[-58.7329281134421,-27.4582611732073],[-58.732824219078,-27.4587316103186],[-58.7350453527351,-27.458482913846],[-58.7381646493773,-27.4581101991814],[-58.7391887935158,-27.4579575710467],[-58.7401820327767,-27.4577692337338],[-58.7400451279389,-27.45742359807],[-58.7398592946056,-27.4571823263955],[-58.7395437104534,-27.4570509391629],[-58.7394627054396,-27.4567226484781],[-58.7394788225729,-27.4564608094988],[-58.7398032705334,-27.4561906077636],[-58.7400443892737,-27.4560883533075],[-58.7400758847111,-27.4558398551156],[-58.73989232001,-27.4557429068106],[-58.739722648433,-27.455564586792],[-58.7396595308385,-27.4550872098547],[-58.7397815340403,-27.4548060040677],[-58.7396501858754,-27.4544918752624],[-58.7393138916057,-27.4543291689274],[-58.7387966553809,-27.4542363859633],[-58.7387210645366,-27.4539305819661],[-58.7386178611768,-27.4534762597176],[-58.7388317159734,-27.4532480399376],[-58.7394667436648,-27.4531138019578],[-58.7394818397567,-27.4531091024103],[-58.7399967345527,-27.4530530494044],[-58.7407721832169,-27.4528448751777],[-58.7413049600311,-27.4526397310806],[-58.7418739267951,-27.4521634727793],[-58.742976771124,-27.4518745045966],[-58.7462867482481,-27.451422541473],[-58.7474825618702,-27.4512586800794],[-58.7475201618505,-27.4510777688603],[-58.7484997211248,-27.4509887878841],[-58.7495195800316,-27.4508902718751],[-58.7502640917298,-27.4512869060609],[-58.7510357387219,-27.4518004804014],[-58.7515826675829,-27.4521725252508],[-58.7520017851266,-27.4524559561379],[-58.7527485980898,-27.4529968986221],[-58.7539808397708,-27.4538565142008],[-58.7557081429762,-27.4550030908638],[-58.7544238270504,-27.4575634657548],[-58.7554212626236,-27.4579613940155],[-58.7558342128467,-27.4581727142747],[-58.7566689425523,-27.458514042109],[-58.7568923284283,-27.4585698664469],[-58.7581919804023,-27.4569791351777],[-58.7591592587487,-27.4577067176662],[-58.7609714378663,-27.4590957441955],[-58.7621944869596,-27.4600050186269],[-58.7656653479451,-27.4626586010341],[-58.7663580569944,-27.4601146588759],[-58.7657850431359,-27.4596978967957],[-58.7648994610194,-27.4590234587177],[-58.76395243029,-27.4583001724396],[-58.7627599371036,-27.4574040592028],[-58.7593256338048,-27.4548085751558],[-58.7581638348097,-27.4539300756441],[-58.7578111348967,-27.4536909355054],[-58.7576168763475,-27.4535580581842],[-58.7567878612697,-27.4529369822804],[-58.7552427942132,-27.4518016543231],[-58.7544493365809,-27.4511891372587],[-58.7536408639443,-27.450585826331],[-58.7532622648657,-27.4503064011412],[-58.7527351342352,-27.449907047658],[-58.7519220523604,-27.4493308498902],[-58.7506628204705,-27.4483587779571],[-58.7503431216279,-27.4486063890113],[-58.7491174366387,-27.4487977149683],[-58.7481585457576,-27.4489135061489],[-58.747219803078,-27.449024527052],[-58.7458519862187,-27.4491815195608],[-58.7450597037044,-27.4492816681428],[-58.7440548780507,-27.4493709408797]]]}"
189,188,240,428,118,131,33.7,13,"{""type"":""Polygon"",""coordinates"":[[[-58.8257859532006,-27.483111336252],[-58.8257710804859,-27.4831295748041],[-58.82503755221,-27.4840413679915],[-58.8253402973001,-27.4864507050235],[-58.8254218055274,-27.4870991988716],[-58.8255011575795,-27.4876169061042],[-58.8256167298995,-27.488490495443],[-58.8257164611647,-27.4890169567103],[-58.8257618282272,-27.4893140777152],[-58.8257958165107,-27.4895346635053],[-58.8258652074279,-27.4900615226581],[-58.8272631861243,-27.4898717581603],[-58.8271994415314,-27.4893809125826],[-58.8285474344945,-27.4892278787269],[-58.8296985721135,-27.4890999749264],[-58.8309049605159,-27.4889487804475],[-58.8309019012801,-27.4887638760368],[-58.8308863404512,-27.4884347890577],[-58.8308791196891,-27.4883040695411],[-58.8308513560572,-27.4878488394066],[-58.830823294338,-27.4873755697678],[-58.8308006629235,-27.4869247828727],[-58.8312366248341,-27.4860664962142],[-58.8312267004988,-27.4854666841893],[-58.8311983399475,-27.4849753750597],[-58.8310692333495,-27.4848146834479],[-58.8294015018926,-27.4842862943797],[-58.8285574536523,-27.484017715062],[-58.8258673076452,-27.4831373340074],[-58.8257859532006,-27.483111336252]]]}"
190,196,260,456,128,142,4.87,94,"{""type"":""Polygon"",""coordinates"":[[[-58.8309049605159,-27.4889487804475],[-58.8296985721135,-27.4890999749264],[-58.8285474344945,-27.4892278787269],[-58.8271994415314,-27.4893809125826],[-58.8272631861243,-27.4898717581603],[-58.8258652074279,-27.4900615226581],[-58.8259389864863,-27.4905477264645],[-58.8264893908996,-27.4904908828798],[-58.8273374924303,-27.4903895300464],[-58.8275797110444,-27.490354772752],[-58.8287056510892,-27.4902317185542],[-58.8291903099526,-27.4901757284605],[-58.8298514434512,-27.4900858400061],[-58.8309622059588,-27.4899629673107],[-58.8309479131013,-27.4897105480808],[-58.8309433613116,-27.4894354464313],[-58.8309246831775,-27.4892236824906],[-58.8309049605159,-27.4889487804475]]]}"
173,56,47,103,27,51,1851.49,0,"{""type"":""Polygon"",""coordinates"":[[[-58.6830129786192,-27.4869818235834],[-58.6806491536756,-27.4868750609034],[-58.6779607104908,-27.4873766545028],[-58.6792512558959,-27.495088524877],[-58.6728117446693,-27.4957660703241],[-58.6663845261447,-27.4962582188201],[-58.6671642163975,-27.5023433290129],[-58.6652489748036,-27.5024835576395],[-58.6620321967166,-27.502869381664],[-58.6583798521484,-27.5032242368356],[-58.6625530803999,-27.5116056070872],[-58.6681024497348,-27.5155765526413],[-58.6844161140665,-27.5140220828027],[-58.6845290920074,-27.5154597343157],[-58.6853166845003,-27.5156802540962],[-58.6909174291103,-27.5173219418256],[-58.6918468053326,-27.5155648711254],[-58.6986270503354,-27.5142777735226],[-58.694915861063,-27.5246668191466],[-58.6994330860064,-27.5258973128168],[-58.6986614240379,-27.5280359394245],[-58.6992716395723,-27.5279021735864],[-58.7108001947399,-27.5263759018741],[-58.7151215632182,-27.525731716659],[-58.7140412665845,-27.5193710109926],[-58.7182632380807,-27.5221157126079],[-58.7179399220753,-27.5192191439785],[-58.7221824082229,-27.5184043064494],[-58.7198301666839,-27.5011969285383],[-58.7199985124472,-27.4999859004586],[-58.7192658298033,-27.5000400675826],[-58.7191889110171,-27.4999733532564],[-58.7190821360779,-27.4999385848155],[-58.7189698127687,-27.4998723078732],[-58.7189334268544,-27.4998096035277],[-58.718937082937,-27.4997193384133],[-58.7179378081057,-27.4998715233698],[-58.7167017921839,-27.5000897769486],[-58.7159443767895,-27.5001803198562],[-58.7159060130235,-27.5003161230966],[-58.7158665297603,-27.5003797641249],[-58.7157914316285,-27.5004303114243],[-58.7156353378533,-27.5004773466304],[-58.7154755584226,-27.4999605519512],[-58.7152454360253,-27.4988221060287],[-58.7149505474402,-27.4977476118525],[-58.7148520036207,-27.4975909414672],[-58.7146060219077,-27.4964075791906],[-58.7144768351065,-27.4955791463274],[-58.7145155488083,-27.4954658941084],[-58.7145279958284,-27.4952898115034],[-58.714245468071,-27.4953384030116],[-58.7141295620716,-27.4953668971354],[-58.7140033311441,-27.4953819853471],[-58.7139060485518,-27.4953064967045],[-58.7137940124227,-27.4952582557661],[-58.713237005116,-27.494895213387],[-58.7125724656547,-27.4944477831507],[-58.7124147032864,-27.4943865708651],[-58.7122619288652,-27.4943207859987],[-58.7120284427639,-27.4942695271856],[-58.711494711588,-27.494429468197],[-58.7114392176741,-27.4944391728617],[-58.7113884325216,-27.4944262645322],[-58.7110044404949,-27.4941287496332],[-58.7103454279699,-27.4933835134707],[-58.7099688390884,-27.49290997494],[-58.7097222153183,-27.4923355959852],[-58.7095795420982,-27.4912862827549],[-58.7087163630202,-27.4858340436477],[-58.7079941811647,-27.4862353680959],[-58.7033189944017,-27.4805546446438],[-58.7018568350553,-27.4805274212969],[-58.6982901853593,-27.4817934792637],[-58.6968498468305,-27.481211079857],[-58.6948346370393,-27.4830535842008],[-58.694258418363,-27.4840710732822],[-58.6900471861827,-27.4848756233508],[-58.6890268719364,-27.4856323332635],[-58.6830129786192,-27.4869818235834]]]}"
174,86,84,170,46,66,2242.56,0,"{""type"":""Polygon"",""coordinates"":[[[-58.6717364829278,-27.4738100873239],[-58.6669813702863,-27.4744219755919],[-58.6636949119474,-27.4751650230915],[-58.6631191726453,-27.4732005581612],[-58.6628133779351,-27.4706870237546],[-58.6528008522652,-27.4721370327084],[-58.6464935519515,-27.4731275309449],[-58.6390091470236,-27.4742173224504],[-58.636858994119,-27.4745178009075],[-58.6363593140415,-27.4752725219369],[-58.6363485508827,-27.4759132276824],[-58.6358452560966,-27.476081543744],[-58.6357145818225,-27.476480058093],[-58.6357246497783,-27.4775039643012],[-58.6353284101933,-27.477729665169],[-58.6356158674791,-27.4780149992983],[-58.6356975199593,-27.478406507259],[-58.6356421658342,-27.4787680473873],[-58.6357592260905,-27.4795019842554],[-58.635477567488,-27.4799518950387],[-58.6354469047945,-27.4806153899273],[-58.6349992162325,-27.4807830501281],[-58.6346241247196,-27.4810716565579],[-58.6344575745908,-27.4814390133038],[-58.6348596237701,-27.4816057137223],[-58.6345772239529,-27.4820060092339],[-58.634703725589,-27.4823518796482],[-58.6342594214862,-27.482406719938],[-58.6340215341893,-27.4827388249096],[-58.6341485011607,-27.4831162681983],[-58.6345920089564,-27.483007304099],[-58.6349393001799,-27.4832332917365],[-58.635005516803,-27.4836069366511],[-58.6349500254962,-27.4839594557861],[-58.6350211668026,-27.4843240205513],[-58.6350771366261,-27.4846887634995],[-58.6350319597786,-27.485054694792],[-58.6348553576335,-27.485426681187],[-58.6347344522636,-27.4858025242387],[-58.6347297386737,-27.4865108249889],[-58.6350566785595,-27.4867280287061],[-58.6347674112413,-27.4870066052727],[-58.6349022421734,-27.4875734219147],[-58.6345383757271,-27.4879385856916],[-58.6345749824295,-27.4883622006108],[-58.6348299292935,-27.4888418949922],[-58.6350947270003,-27.4893034285939],[-58.6349311061037,-27.4902120851789],[-58.6353429038085,-27.4903516017436],[-58.6355066218782,-27.4908188333264],[-58.6351941902086,-27.4912420388388],[-58.6356541776168,-27.4915614325114],[-58.6354540132734,-27.4920509855197],[-58.6356722359371,-27.4924408871421],[-58.6355863309674,-27.4927892526118],[-58.6354165107754,-27.4932784488619],[-58.6357604461843,-27.4936172502883],[-58.6355119590656,-27.4939179047811],[-58.6352998749539,-27.4942857976781],[-58.6351992609168,-27.4946659135694],[-58.6354564174465,-27.4949516021179],[-58.6356582727052,-27.4952604958386],[-58.6354628270642,-27.4957274378058],[-58.6358317264763,-27.4960433896935],[-58.6357817584376,-27.4964274215218],[-58.6351245681038,-27.4964577024504],[-58.6347588753436,-27.4967010887582],[-58.6343431349892,-27.4969811509705],[-58.6341555316887,-27.4972946213603],[-58.6335534396739,-27.4972881589383],[-58.6331292426459,-27.4976810947694],[-58.6325568969374,-27.4976336788889],[-58.6326545296112,-27.4980791333337],[-58.632721349326,-27.4984933715001],[-58.6324393676722,-27.498925236273],[-58.6321091333527,-27.499172711006],[-58.6315375783622,-27.4991794152535],[-58.6310267193094,-27.4991854055598],[-58.6305874700789,-27.499244688049],[-58.6301199393043,-27.4991013003724],[-58.6299914741002,-27.4999960064285],[-58.6293025734437,-27.5002792545625],[-58.6288969983029,-27.5002208484494],[-58.6284578215931,-27.4999417897508],[-58.6282668647376,-27.5003725810567],[-58.6276972935301,-27.5005145800238],[-58.6274780414018,-27.5010855460549],[-58.6271369274901,-27.501626359396],[-58.6271285207825,-27.5020865917184],[-58.6266668851818,-27.5023446132628],[-58.6266877643955,-27.5027323252309],[-58.6270368961262,-27.503080109206],[-58.6276631698113,-27.503352471766],[-58.6274584900624,-27.5038826671765],[-58.6274352421147,-27.5043656285621],[-58.6270614465952,-27.504748935123],[-58.6264306876177,-27.5048600674759],[-58.6264999440301,-27.5054411916824],[-58.6266122717486,-27.5058549008201],[-58.6270592474994,-27.5063188290242],[-58.6268970994859,-27.5066455259606],[-58.6264915513462,-27.5069344691494],[-58.6264453954254,-27.5075800983515],[-58.6263120517285,-27.5081455469275],[-58.6264575191162,-27.5087483352794],[-58.6266776712179,-27.5092690498626],[-58.6269855603047,-27.5095631820162],[-58.6274321816481,-27.5093143566393],[-58.6277855992483,-27.5096079542039],[-58.6273642037719,-27.5098519744463],[-58.6276780179789,-27.5102046800588],[-58.6284527025977,-27.5102452338587],[-58.629469332551,-27.510224304458],[-58.6302886087623,-27.5105440142702],[-58.6308126285655,-27.5110837147027],[-58.6308110269007,-27.5116611551957],[-58.6301342982773,-27.5124314661334],[-58.6296872666184,-27.5129960826474],[-58.6302142968346,-27.5130530611866],[-58.63145779239,-27.5122896355784],[-58.633516639099,-27.5119226242634],[-58.6348275463178,-27.5119568427327],[-58.6356050461311,-27.5121867892974],[-58.6360078256883,-27.5127369169889],[-58.6368534993368,-27.513128453824],[-58.6370688016119,-27.5140010725023],[-58.6365233484681,-27.514408980128],[-58.6361058131714,-27.5145717815015],[-58.6368480733725,-27.5151540005322],[-58.6374243755047,-27.5164870114269],[-58.6385154015812,-27.5163613828741],[-58.6389375302121,-27.5161669424022],[-58.6387294948155,-27.5147619326679],[-58.6386468395485,-27.5139644428042],[-58.6389703035739,-27.5135997433933],[-58.6396086298736,-27.5136553743341],[-58.6401330434267,-27.5142175882993],[-58.6406621863715,-27.5147571888148],[-58.641459643226,-27.5159883282314],[-58.6414705602825,-27.5167235070887],[-58.6416876835943,-27.5173750519346],[-58.6422592297444,-27.517702123636],[-58.6429740358165,-27.5181357663526],[-58.6435721581372,-27.5185482289965],[-58.6446216757886,-27.5180125339662],[-58.6451813509678,-27.5175412716729],[-58.6456749659182,-27.5173910760475],[-58.6461707288956,-27.5173852079552],[-58.6466471104741,-27.5177765428954],[-58.6473128906772,-27.5183144981436],[-58.6474459330875,-27.5190933389945],[-58.6469780601338,-27.5196131448113],[-58.6459378978858,-27.5204374561676],[-58.6451690722842,-27.5204555771607],[-58.6442161516012,-27.5206833808445],[-58.6440583307493,-27.5212987544605],[-58.6445322395921,-27.5215232153114],[-58.6456916229924,-27.5215681417348],[-58.646726548046,-27.5217498649359],[-58.6474876521402,-27.522570887236],[-58.6491072505425,-27.5215818052464],[-58.6495950004775,-27.5217158627528],[-58.6513437137082,-27.5225973195409],[-58.652257981849,-27.5224917252511],[-58.6539624594652,-27.5217677325559],[-58.6563392023395,-27.5206612942005],[-58.6567534935739,-27.5206202698439],[-58.6582441497116,-27.5211618722999],[-58.6681303724689,-27.5258072853425],[-58.6709946800619,-27.5271668008308],[-58.6748034248569,-27.5284021037777],[-58.6769258512869,-27.5288817536685],[-58.6785245973478,-27.5295300919175],[-58.6792587001774,-27.5302204359981],[-58.6853166845003,-27.5156802540962],[-58.6845290920074,-27.5154597343157],[-58.6844161140665,-27.5140220828027],[-58.6681024497348,-27.5155765526413],[-58.6625530803999,-27.5116056070872],[-58.6583798521484,-27.5032242368356],[-58.6620321967166,-27.502869381664],[-58.6652489748036,-27.5024835576395],[-58.6671642163975,-27.5023433290129],[-58.6663845261447,-27.4962582188201],[-58.6728117446693,-27.4957660703241],[-58.6792512558959,-27.495088524877],[-58.6779607104908,-27.4873766545028],[-58.6806491536756,-27.4868750609034],[-58.6830129786192,-27.4869818235834],[-58.68215548209,-27.4838118980554],[-58.6823336865202,-27.483223306658],[-58.6821317391335,-27.4815837230434],[-58.6818882870825,-27.4808739181673],[-58.6807080783806,-27.4784296475236],[-58.6804231156508,-27.4729837240243],[-58.6804140983227,-27.470056151308],[-58.6788419245208,-27.4707698242659],[-58.6788488297335,-27.4712253588585],[-58.675473853377,-27.4724569426227],[-58.6717364829278,-27.4738100873239]]]}"
175,63,70,133,35,45,949.54,0,"{""type"":""Polygon"",""coordinates"":[[[-58.6853166845003,-27.5156802540962],[-58.6792587001774,-27.5302204359981],[-58.6880981291669,-27.539108343307],[-58.6922112357492,-27.5406822864755],[-58.6939278657172,-27.5410808970141],[-58.6971954332482,-27.5416319716901],[-58.6984635698092,-27.5418239846321],[-58.6994520331095,-27.5419291862717],[-58.7018091439154,-27.5421800229862],[-58.7057072290141,-27.5425923533205],[-58.706268226508,-27.5431989608505],[-58.7063954765542,-27.5439011124994],[-58.7068466710359,-27.5442790052147],[-58.7140512736509,-27.5444745166312],[-58.7169146057431,-27.5440782905467],[-58.7188917435248,-27.5436478609112],[-58.7207826370021,-27.5432049386801],[-58.721086156348,-27.5435214586367],[-58.7212626924823,-27.5441327636968],[-58.7219773999989,-27.544529896003],[-58.725908762726,-27.5431774554237],[-58.7264721610643,-27.5432832309988],[-58.7255862077996,-27.5387291401546],[-58.7235949121346,-27.5268945073298],[-58.7221824082229,-27.5184043064494],[-58.7179399220753,-27.5192191439785],[-58.7182632380807,-27.5221157126079],[-58.7140412665845,-27.5193710109926],[-58.7151215632182,-27.525731716659],[-58.7108001947399,-27.5263759018741],[-58.6992716395723,-27.5279021735864],[-58.6986614240379,-27.5280359394245],[-58.6994330860064,-27.5258973128168],[-58.694915861063,-27.5246668191466],[-58.6986270503354,-27.5142777735226],[-58.6918468053326,-27.5155648711254],[-58.6909174291103,-27.5173219418256],[-58.6853166845003,-27.5156802540962]]]}"
183,680,696,1376,348,346,116.85,12,"{""type"":""Polygon"",""coordinates"":[[[-58.8073193457431,-27.513742147479],[-58.8067904730874,-27.514195595798],[-58.8064769635796,-27.5145154295122],[-58.8062180614635,-27.5147714011514],[-58.8057788285887,-27.5151379750411],[-58.8054549022744,-27.5154398984132],[-58.805718400564,-27.5157747919052],[-58.8062570864844,-27.5159211649784],[-58.8066250440782,-27.5161464388987],[-58.8071646913778,-27.5163514370767],[-58.8075506729828,-27.5164411482733],[-58.8077453973312,-27.516591986199],[-58.8078307989566,-27.5165547889895],[-58.8079632008756,-27.5166071978767],[-58.8082233894048,-27.5167391404485],[-58.8090004894512,-27.5169229997277],[-58.809319755972,-27.5169549326337],[-58.8097114640213,-27.5170851609055],[-58.8101632085052,-27.5171740087473],[-58.8105937597878,-27.5172044899024],[-58.8108526965131,-27.5172597590941],[-58.8110028619425,-27.5174698136745],[-58.8119341619079,-27.5178005059673],[-58.8126859825107,-27.5179846735402],[-58.8133767347047,-27.5181470791331],[-58.8140684510277,-27.518368109721],[-58.8145410294152,-27.518492757997],[-58.8147974529362,-27.518394683494],[-58.8151616576659,-27.5183899294035],[-58.8155729436463,-27.5184792874575],[-58.8156630854101,-27.5187307180012],[-58.8159649403834,-27.5189342750225],[-58.8163519187652,-27.5187758514416],[-58.8174407532939,-27.5185315701279],[-58.8191720079157,-27.5179721393415],[-58.8201131693118,-27.5176711285463],[-58.8200991825204,-27.517743485143],[-58.8205841159379,-27.5176965389333],[-58.8206663867727,-27.5177766568822],[-58.8254483798937,-27.517519992877],[-58.828254109,-27.5173838914817],[-58.8288042713552,-27.5173044832391],[-58.8288630308914,-27.517186428762],[-58.8290949665723,-27.5171382696301],[-58.8291944159883,-27.5170332122583],[-58.8294166824512,-27.5170122447926],[-58.829667656173,-27.5168916609487],[-58.8294183468844,-27.5161957623922],[-58.8293820433962,-27.5161421100348],[-58.82952389848,-27.5161537761721],[-58.8299796640649,-27.5161793545949],[-58.8318336003162,-27.5163128223215],[-58.8320223255067,-27.516405063317],[-58.8320579575768,-27.5164181263303],[-58.832277032706,-27.5165099670818],[-58.8325349554982,-27.5168087935393],[-58.8327454108085,-27.5169909636372],[-58.83331163938,-27.5169654558603],[-58.8334857904566,-27.517093973535],[-58.8335925673513,-27.5174308774004],[-58.8335178440234,-27.5178062612278],[-58.8335047180877,-27.5182349626638],[-58.8336570215466,-27.5185712660348],[-58.8340145488229,-27.5187740484547],[-58.8345185455537,-27.5189613649704],[-58.8352163828565,-27.5183296624281],[-58.8354102878905,-27.5181241159629],[-58.8357109412346,-27.5179487357057],[-58.8359014736897,-27.5175402461608],[-58.8361371909747,-27.51741534146],[-58.8364346191725,-27.5170460370162],[-58.8364741491148,-27.5166846492383],[-58.8366963751385,-27.516356934902],[-58.8366925532633,-27.516126933507],[-58.8367987761739,-27.5161255303801],[-58.8371133972828,-27.5158777896733],[-58.8373812542944,-27.5152517572995],[-58.8366768166079,-27.5151798688541],[-58.8365069741321,-27.5150061900484],[-58.836447662817,-27.51478594308],[-58.835734235513,-27.5147818307951],[-58.8350812066876,-27.5147588744891],[-58.8346397980059,-27.5146835041429],[-58.833974707937,-27.5145434202587],[-58.8330289795404,-27.514564911738],[-58.8318944536071,-27.5144896458709],[-58.8300488725262,-27.5142478079156],[-58.8291667363384,-27.5141376219484],[-58.828639568098,-27.514076892856],[-58.8283354069636,-27.5140402948153],[-58.8278031067249,-27.5139751191547],[-58.8215787415059,-27.5132719073356],[-58.8216336427198,-27.5129193422665],[-58.8196492955665,-27.5128505942422],[-58.8197891316387,-27.5130472416832],[-58.8199777584646,-27.5134417276824],[-58.820197181313,-27.513862875337],[-58.8204009857157,-27.5142571619501],[-58.8205213273571,-27.5148059096615],[-58.8205158902223,-27.5150901641019],[-58.8205072592569,-27.5151804940045],[-58.8197211535835,-27.5150644798621],[-58.8194067265486,-27.5150189749125],[-58.8190608371127,-27.5149062181128],[-58.8182806086685,-27.5148397381413],[-58.8179913254609,-27.5147848794621],[-58.817240187118,-27.5146413288146],[-58.8170828633204,-27.5146118087462],[-58.8168394016194,-27.5145743922581],[-58.816332245768,-27.514499822258],[-58.8154699784465,-27.5143667350929],[-58.8151351736246,-27.5143124646718],[-58.8141359670791,-27.5141586022621],[-58.8135121796967,-27.5140674999201],[-58.8130758425453,-27.5139919942701],[-58.8129541498135,-27.5139755374499],[-58.8126395059103,-27.5139164872207],[-58.8120001765182,-27.513803026292],[-58.8114376818845,-27.5137472026848],[-58.8113362223655,-27.5137304808613],[-58.8113108574899,-27.5137263003937],[-58.8107327456133,-27.5136436121645],[-58.810661857031,-27.5136400243461],[-58.8106314340008,-27.5136359096136],[-58.809876950755,-27.5135961118756],[-58.8079120528204,-27.5131705849069],[-58.8073541633241,-27.5137056080393],[-58.8073193457431,-27.513742147479]]]}"
176,420,78,498,48,70,1335.16,0,"{""type"":""Polygon"",""coordinates"":[[[-58.6474876521402,-27.522570887236],[-58.6485206792763,-27.5233029705513],[-58.6486723595036,-27.5239733224257],[-58.6485824944188,-27.5243939181356],[-58.6479538568181,-27.524992321949],[-58.6473426922262,-27.5254055618838],[-58.6464338560428,-27.525538126842],[-58.6464634344771,-27.5261648164199],[-58.6469952222361,-27.5268757787453],[-58.647100609955,-27.5278353894637],[-58.6469053314924,-27.52899253845],[-58.6466805672274,-27.5302086803751],[-58.6477790859151,-27.5312557656699],[-58.6484525059551,-27.5319605308239],[-58.6483979611128,-27.5330528569984],[-58.6481662757314,-27.5338044421745],[-58.6486216353124,-27.5337990420665],[-58.6490318723267,-27.5334829119479],[-58.6495827711075,-27.5327591151784],[-58.6499897072435,-27.5318836489158],[-58.650329039614,-27.5312255155414],[-58.6508081350163,-27.5311160722128],[-58.6511353086181,-27.5313377398874],[-58.651633624179,-27.5321753896871],[-58.6519311876582,-27.5324470288617],[-58.652402190886,-27.5321346781029],[-58.652844791768,-27.5319534844594],[-58.6534209656381,-27.5322443625813],[-58.6534818857071,-27.5325955010154],[-58.6532596092877,-27.5329590300883],[-58.6527956218879,-27.533402121232],[-58.652613480577,-27.5337426167901],[-58.6525327344211,-27.5347720996563],[-58.6531711870636,-27.5348276624789],[-58.653923039049,-27.5346833862641],[-58.6544546178673,-27.5340229558797],[-58.6550003553235,-27.5332946890907],[-58.6555890055605,-27.5330666371047],[-58.6561079820787,-27.5332544304572],[-58.6563695467576,-27.533824218532],[-58.6568080490187,-27.5340445454559],[-58.6573477118949,-27.5335870059067],[-58.6578804655839,-27.5326694187636],[-58.6579184694386,-27.5318299084489],[-58.657975374305,-27.5312382809128],[-58.6583627821029,-27.5310893057718],[-58.6588199567554,-27.5312056495281],[-58.6593476930324,-27.5313031052293],[-58.6598315664365,-27.5311755297807],[-58.6605410350165,-27.5312437444736],[-58.6615208912897,-27.5314575887143],[-58.6622526666374,-27.5319991886002],[-58.6625932417341,-27.532437198722],[-58.6628885867998,-27.5339042688794],[-58.6639229069731,-27.534708391173],[-58.6647892849138,-27.5351130335073],[-58.6655581085731,-27.5354241072462],[-58.6664446918848,-27.5354901682559],[-58.6684561737217,-27.5349833555149],[-58.6689426922237,-27.5353654643186],[-58.6690656577095,-27.5361353760526],[-58.6689035491737,-27.5374635690322],[-58.6686558827074,-27.5391581833146],[-58.6683029077716,-27.5409172157917],[-58.6686228709404,-27.5416622070817],[-58.6693407972146,-27.5422851305481],[-58.6703301246126,-27.5427829901414],[-58.6714078842132,-27.5427700318061],[-58.6728913916574,-27.5428153357967],[-58.6738788923854,-27.543191393524],[-58.674887597099,-27.5436303428517],[-58.6757338491578,-27.544368971539],[-58.6767608934963,-27.5446813766814],[-58.677655424087,-27.5449322195531],[-58.6787709372475,-27.5447383066299],[-58.6795437235302,-27.5443049323439],[-58.6803753497663,-27.5434152291268],[-58.6808092659944,-27.543328783115],[-58.6811115085771,-27.5435687223112],[-58.6814445700476,-27.544502985157],[-58.6816135192741,-27.5452948803666],[-58.682239222495,-27.5458376513598],[-58.682785676163,-27.5471572741139],[-58.683063847678,-27.5488049371666],[-58.683777101531,-27.5507721201526],[-58.6843145128431,-27.5521595094086],[-58.6845318616602,-27.5537988826247],[-58.684723606599,-27.5557498251239],[-58.6849435859096,-27.5568974646328],[-58.685732137719,-27.5574923731679],[-58.6863975497823,-27.5576466932049],[-58.6872859986203,-27.5574915527902],[-58.6885479350368,-27.5575980167569],[-58.6904665882873,-27.5586122123574],[-58.6908647691617,-27.55883291625],[-58.6914068607387,-27.559196218715],[-58.6917325248276,-27.5596388418459],[-58.6914274516678,-27.5608695484072],[-58.6914439906039,-27.5616181726293],[-58.6917752765707,-27.5620968147948],[-58.692703130006,-27.5618689829948],[-58.6936119199477,-27.5613887618478],[-58.6955347796836,-27.5600345609822],[-58.6975463919734,-27.5585303875282],[-58.6991167517453,-27.558285639167],[-58.6997825311451,-27.5584624446809],[-58.6999968929184,-27.5589064093178],[-58.6996344412804,-27.5600205474796],[-58.6992467387716,-27.5608102025825],[-58.6992923159779,-27.5617975512026],[-58.6997571146559,-27.5630549402499],[-58.7003841064421,-27.5633404800698],[-58.7011581790663,-27.5629881669569],[-58.7020475112422,-27.5622329598902],[-58.7033606295838,-27.5607327502397],[-58.7039838061141,-27.5601161245474],[-58.7044275816121,-27.5596821368515],[-58.7051001247609,-27.5593130046517],[-58.7057222961816,-27.559287322315],[-58.7073424795586,-27.5596463403009],[-58.7081843183465,-27.5600780663186],[-58.7087417839849,-27.5597960404275],[-58.7092826975252,-27.5590992063716],[-58.7099187907751,-27.5573591636341],[-58.7102727289759,-27.5566826713368],[-58.7109537457044,-27.5562096551413],[-58.7114046821448,-27.5562401884528],[-58.7119342537772,-27.5564456792285],[-58.7129451832402,-27.5592931731328],[-58.7136150858736,-27.5603855870976],[-58.7143913458948,-27.5614811955371],[-58.7174175178941,-27.5627384585788],[-58.7179339119473,-27.5633951838894],[-58.7181331736773,-27.5638393042522],[-58.7186819124077,-27.5639723549943],[-58.7192752850877,-27.5637214195569],[-58.7203398583626,-27.5628511560351],[-58.7210934582123,-27.561515598798],[-58.7219025104218,-27.560815395395],[-58.7229109670933,-27.5605683209422],[-58.7235680677131,-27.5605105485617],[-58.72438669764,-27.5607484908843],[-58.7252603800695,-27.56126993446],[-58.7257285952916,-27.5594913140865],[-58.7260296289965,-27.5583508139117],[-58.7262971084609,-27.5579775920577],[-58.7268296131531,-27.5573980826666],[-58.7271894457656,-27.5571049083078],[-58.7286128694396,-27.5558872904946],[-58.7264721610643,-27.5432832309988],[-58.725908762726,-27.5431774554237],[-58.7219773999989,-27.544529896003],[-58.7212626924823,-27.5441327636968],[-58.721086156348,-27.5435214586367],[-58.7207826370021,-27.5432049386801],[-58.7188917435248,-27.5436478609112],[-58.7169146057431,-27.5440782905467],[-58.7140512736509,-27.5444745166312],[-58.7068466710359,-27.5442790052147],[-58.7063954765542,-27.5439011124994],[-58.706268226508,-27.5431989608505],[-58.7057072290141,-27.5425923533205],[-58.7018091439154,-27.5421800229862],[-58.6994520331095,-27.5419291862717],[-58.6984635698092,-27.5418239846321],[-58.6971954332482,-27.5416319716901],[-58.6939278657172,-27.5410808970141],[-58.6922112357492,-27.5406822864755],[-58.6880981291669,-27.539108343307],[-58.6792587001774,-27.5302204359981],[-58.6785245973478,-27.5295300919175],[-58.6769258512869,-27.5288817536685],[-58.6748034248569,-27.5284021037777],[-58.6709946800619,-27.5271668008308],[-58.6681303724689,-27.5258072853425],[-58.6582441497116,-27.5211618722999],[-58.6567534935739,-27.5206202698439],[-58.6563392023395,-27.5206612942005],[-58.6539624594652,-27.5217677325559],[-58.652257981849,-27.5224917252511],[-58.6513437137082,-27.5225973195409],[-58.6495950004775,-27.5217158627528],[-58.6491072505425,-27.5215818052464],[-58.6474876521402,-27.522570887236]]]}"
177,368,352,720,187,205,481.29,1,"{""type"":""Polygon"",""coordinates"":[[[-58.7264721610643,-27.5432832309988],[-58.7286128694396,-27.5558872904946],[-58.7271894457656,-27.5571049083078],[-58.7268296131531,-27.5573980826666],[-58.7262971084609,-27.5579775920577],[-58.7260296289965,-27.5583508139117],[-58.7257285952916,-27.5594913140865],[-58.7252603800695,-27.56126993446],[-58.7260219097689,-27.5620634229361],[-58.7271056623959,-27.5630694260431],[-58.7278992971606,-27.5633257012604],[-58.7287536357609,-27.5632564281663],[-58.7292732311987,-27.5628214203058],[-58.7298152263367,-27.5622011829036],[-58.7303705580956,-27.5614634928324],[-58.7304112724812,-27.5595413229067],[-58.7306929680636,-27.5587844855452],[-58.731150712012,-27.5586028548952],[-58.731537572614,-27.5587423834485],[-58.7322831665399,-27.5594864151608],[-58.7329585206643,-27.5599471294156],[-58.734533026636,-27.5602928636321],[-58.7357618176706,-27.561184212672],[-58.7360679145373,-27.5616585466077],[-58.7364220237679,-27.5626104387601],[-58.7367103506543,-27.5635631522282],[-58.7375578660182,-27.5643464767976],[-58.7386924175507,-27.5637503685716],[-58.739542942334,-27.5624766582426],[-58.7406732817543,-27.5609738903569],[-58.7407873588612,-27.5595424955421],[-58.739972947598,-27.5582896380131],[-58.73950429627,-27.5571361972292],[-58.7395480158385,-27.5563778126845],[-58.7406163363926,-27.5557599658736],[-58.7413500818991,-27.555750770437],[-58.7428921175149,-27.5562862772196],[-58.7436870880751,-27.5566281536659],[-58.7450475361467,-27.5565614505529],[-58.7454350374552,-27.5561009786915],[-58.7462668285442,-27.5549312171723],[-58.7472825743077,-27.554512462241],[-58.7488680724406,-27.554596263333],[-58.7500131342212,-27.5549923377343],[-58.7503558325629,-27.552985171096],[-58.7507758997063,-27.5494748911073],[-58.7518165752162,-27.5445719324593],[-58.7529819409984,-27.5414717636537],[-58.7535989691865,-27.5401738543978],[-58.7542102348505,-27.5391511818455],[-58.7550303907453,-27.5385363632735],[-58.7539421183532,-27.5378824847636],[-58.7516236290543,-27.5371944870753],[-58.7505090518131,-27.5371138002334],[-58.7489129240345,-27.5376210752804],[-58.7476842675696,-27.538006427641],[-58.7455047020395,-27.5387420358769],[-58.7433417796658,-27.5395721317681],[-58.7402324364646,-27.5410410705345],[-58.7362342215091,-27.5432743788161],[-58.7349865447647,-27.5431005020658],[-58.7337441435227,-27.5429400809998],[-58.7313155664364,-27.5432996587801],[-58.7282277386985,-27.5438974538962],[-58.7271896116072,-27.5435314403181],[-58.7264721610643,-27.5432832309988]]]}"
178,281,290,571,148,173,2255.16,0,"{""type"":""Polygon"",""coordinates"":[[[-58.7232685188152,-27.4897235186339],[-58.7227771142621,-27.4896754716939],[-58.7229441439222,-27.4903320091607],[-58.7230431110933,-27.4911653180295],[-58.7232567856088,-27.4922182448286],[-58.7234333762416,-27.4931633665086],[-58.7221463817131,-27.4933507203212],[-58.7218793163818,-27.4934171796792],[-58.7217276611996,-27.4934235674513],[-58.7215915294088,-27.4934523179617],[-58.7210866197665,-27.4935126966511],[-58.7210197495855,-27.4934413478654],[-58.7199848515959,-27.4935759423195],[-58.7189451733949,-27.4937286322096],[-58.7191313552537,-27.4946420648248],[-58.7192876855271,-27.4955874428746],[-58.7194634083935,-27.496478448886],[-58.7196397654642,-27.4974100456132],[-58.7197902061813,-27.4983013633222],[-58.7198786329776,-27.4987829467446],[-58.7199612314847,-27.4992149811607],[-58.7199985124472,-27.4999859004586],[-58.7198301666839,-27.5011969285383],[-58.7221824082229,-27.5184043064494],[-58.7235949121346,-27.5268945073298],[-58.7255862077996,-27.5387291401546],[-58.7264721610643,-27.5432832309988],[-58.7271896116072,-27.5435314403181],[-58.7282277386985,-27.5438974538962],[-58.7313155664364,-27.5432996587801],[-58.7337441435227,-27.5429400809998],[-58.7349865447647,-27.5431005020658],[-58.7362342215091,-27.5432743788161],[-58.7402324364646,-27.5410410705345],[-58.7433417796658,-27.5395721317681],[-58.7455047020395,-27.5387420358769],[-58.7476842675696,-27.538006427641],[-58.7489129240345,-27.5376210752804],[-58.7505090518131,-27.5371138002334],[-58.7516236290543,-27.5371944870753],[-58.7539421183532,-27.5378824847636],[-58.7550303907453,-27.5385363632735],[-58.7574486407526,-27.5356323471448],[-58.7594596691286,-27.533220626931],[-58.7603282157213,-27.5321540744793],[-58.7613028437069,-27.5310771510662],[-58.7622709549183,-27.5299100855411],[-58.7632000854349,-27.5288382375126],[-58.7635658856333,-27.5282967979719],[-58.7638808766424,-27.5277424694984],[-58.7651810958315,-27.5248795767451],[-58.7655348974207,-27.5239052367207],[-58.7672463401142,-27.5198687760224],[-58.7687334218028,-27.516362927848],[-58.7692111019926,-27.515229121512],[-58.7701622430441,-27.5130156891473],[-58.7720819032253,-27.5084171705872],[-58.7729491913411,-27.5063446279717],[-58.7722971440439,-27.5057484749927],[-58.7704163229065,-27.5048702437071],[-58.7703447180738,-27.5048215349574],[-58.766097518682,-27.5021148392854],[-58.7653232592935,-27.498294885858],[-58.7652849771349,-27.4981149342963],[-58.764446829555,-27.4934567483251],[-58.7636036814721,-27.4935576573341],[-58.7627404456096,-27.4936678376677],[-58.7616349541719,-27.4938126569028],[-58.7614380736738,-27.4938377043464],[-58.7593836449872,-27.4941118011308],[-58.7561991247286,-27.4945760645591],[-58.7561739089545,-27.4945808938043],[-58.7560133582938,-27.4946641173927],[-58.7557000809659,-27.4946861149284],[-58.7551707627475,-27.4948010564237],[-58.7549495926148,-27.4948895545118],[-58.7546672314749,-27.4949472473671],[-58.7544946329936,-27.4949088255334],[-58.7542018704852,-27.4949486048182],[-58.7539247092115,-27.4950152525216],[-58.7537425677564,-27.4950130376685],[-58.7534248744913,-27.4950756843572],[-58.753259763672,-27.4951905389928],[-58.7531700149394,-27.4952728671251],[-58.7529596002703,-27.4954018251656],[-58.752585629598,-27.4954245804909],[-58.7520805202281,-27.4954715411608],[-58.7517720111986,-27.4954754260763],[-58.7517812566044,-27.4951009004578],[-58.7517094517724,-27.495038651199],[-58.7515860723526,-27.4949138978645],[-58.7512813372776,-27.4948365369307],[-58.7511898026136,-27.4948061124254],[-58.7510328060731,-27.4947945555931],[-58.7507452424267,-27.4948432841077],[-58.7505416579612,-27.4947646486246],[-58.7503446296421,-27.4947806604389],[-58.750127299911,-27.4947924164],[-58.749938888415,-27.4947135891477],[-58.7497965652389,-27.4946702696454],[-58.7497103025351,-27.4946533107133],[-58.7495886374029,-27.494636796934],[-58.749376222675,-27.4946394679891],[-58.7491792656159,-27.4946599882118],[-58.7491294036783,-27.4947057246775],[-58.7488696177143,-27.4945917055895],[-58.7471790601669,-27.4948475160978],[-58.7439561337121,-27.4951270341291],[-58.7436340483941,-27.4942694766421],[-58.7435423255801,-27.4935849592224],[-58.7433495976554,-27.492910729216],[-58.7433293090735,-27.4925861937721],[-58.7431782260503,-27.4926286854459],[-58.7426323088536,-27.4926535679162],[-58.7419603817034,-27.492707091771],[-58.741125977224,-27.4927220470074],[-58.7410349435078,-27.4927231861765],[-58.7404425148045,-27.4926854884843],[-58.7401032414776,-27.4926626662445],[-58.7394950027753,-27.4925845634644],[-58.7393783983663,-27.492567977342],[-58.7386376044679,-27.4924238632229],[-58.7382414959582,-27.4923250600297],[-58.7371751185473,-27.4920632088181],[-58.7303140517261,-27.490326264445],[-58.7232685188152,-27.4897235186339]]]}"
182,686,750,1436,324,339,41.86,34,"{""type"":""Polygon"",""coordinates"":[[[-58.7864261434335,-27.5429494562787],[-58.7863253148129,-27.5439115693677],[-58.7862348232222,-27.544887082075],[-58.786132678737,-27.5457680160403],[-58.7867105830448,-27.5458282494258],[-58.7873239790045,-27.5458925347362],[-58.7872874223837,-27.5464478425311],[-58.7872368544748,-27.5470755044983],[-58.7871741221066,-27.5475770184113],[-58.7870863091648,-27.5480923874897],[-58.7870243059388,-27.5486390006694],[-58.7869860684136,-27.5490905798045],[-58.7868985237446,-27.5499352390161],[-58.7869147987041,-27.5500026927947],[-58.7872669486278,-27.5498718588362],[-58.7874949574848,-27.5495757189092],[-58.7876995847505,-27.5490859119769],[-58.7880905294234,-27.5488508268331],[-58.7885896293947,-27.548731631065],[-58.7892217464743,-27.5487009380921],[-58.7897091746645,-27.5487984104081],[-58.7901494426448,-27.5491084994476],[-58.7907516294685,-27.5494165001647],[-58.7909617923711,-27.5495806933767],[-58.791125475611,-27.5493755943366],[-58.7913502427043,-27.5491922619184],[-58.791550880907,-27.5490814141554],[-58.7918241138435,-27.549077890728],[-58.7919462096302,-27.549116913886],[-58.7920022342921,-27.5491387456444],[-58.7920531258828,-27.5491561327196],[-58.7920116140794,-27.5494047657664],[-58.7919220737128,-27.5495006487959],[-58.7919084315774,-27.5495955529274],[-58.7919858675594,-27.549689282392],[-58.7921381037939,-27.5497143840107],[-58.7923552399442,-27.54968451786],[-58.7925050593004,-27.5495607917012],[-58.7925624820697,-27.5493570619236],[-58.792589252459,-27.5491356841383],[-58.7925870552013,-27.5490003865253],[-58.7926369946381,-27.5489591444204],[-58.7927967126847,-27.5488217576705],[-58.7929634680978,-27.5488060732916],[-58.7931504628593,-27.5487901275109],[-58.793331298632,-27.5487065980069],[-58.7933893789615,-27.548543457227],[-58.7934460669127,-27.5482946279703],[-58.7934885277727,-27.548104623576],[-58.7935001899875,-27.5478879515331],[-58.793556877438,-27.5476391222369],[-58.7935359054845,-27.5475942842994],[-58.7934757047863,-27.5473153877329],[-58.7933232518791,-27.5472767576697],[-58.7931404403849,-27.5472385192225],[-58.7930767927755,-27.5470589059612],[-58.7927325145986,-27.5467385659559],[-58.7924280502899,-27.5466883634529],[-58.7919738517143,-27.5464551458419],[-58.7919049271441,-27.5462620673935],[-58.7919532551184,-27.5461216072399],[-58.7919921223989,-27.5460218668941],[-58.7922139450368,-27.5459693864228],[-58.7922671125679,-27.5458153311483],[-58.7924963446452,-27.545595852575],[-58.7926843658975,-27.5453317966554],[-58.7929966752457,-27.5452420606247],[-58.7934787377549,-27.5453215459303],[-58.7936548744065,-27.5452606311552],[-58.7937890677918,-27.5451100403057],[-58.7938516192876,-27.5449107546981],[-58.793979946193,-27.5447106198894],[-58.7941687686071,-27.544496171285],[-58.7941453051922,-27.5442979961369],[-58.7939053767988,-27.5441702786478],[-58.7938471560523,-27.5440131499235],[-58.7939552435338,-27.5438132764242],[-58.7937962702885,-27.5436845135422],[-58.7936823942913,-27.5435281031544],[-58.79161529126,-27.5433833567857],[-58.7898968660135,-27.5432070234613],[-58.7864261434335,-27.5429494562787]]]}"
179,275,220,495,145,154,2342.46,0,"{""type"":""Polygon"",""coordinates"":[[[-58.8345185455537,-27.5189613649704],[-58.8340145488229,-27.5187740484547],[-58.8336570215466,-27.5185712660348],[-58.8335047180877,-27.5182349626638],[-58.8335178440234,-27.5178062612278],[-58.8335925673513,-27.5174308774004],[-58.8334857904566,-27.517093973535],[-58.83331163938,-27.5169654558603],[-58.8327454108085,-27.5169909636372],[-58.8325349554982,-27.5168087935393],[-58.832277032706,-27.5165099670818],[-58.8320579575768,-27.5164181263303],[-58.8320223255067,-27.516405063317],[-58.8318336003162,-27.5163128223215],[-58.8299796640649,-27.5161793545949],[-58.82952389848,-27.5161537761721],[-58.8293820433962,-27.5161421100348],[-58.8294183468844,-27.5161957623922],[-58.829667656173,-27.5168916609487],[-58.8294166824512,-27.5170122447926],[-58.8291944159883,-27.5170332122583],[-58.8290949665723,-27.5171382696301],[-58.8288630308914,-27.517186428762],[-58.8288042713552,-27.5173044832391],[-58.828254109,-27.5173838914817],[-58.8254483798937,-27.517519992877],[-58.8206663867727,-27.5177766568822],[-58.8205841159379,-27.5176965389333],[-58.8200991825204,-27.517743485143],[-58.8201131693118,-27.5176711285463],[-58.8191720079157,-27.5179721393415],[-58.8174407532939,-27.5185315701279],[-58.8163519187652,-27.5187758514416],[-58.8159649403834,-27.5189342750225],[-58.8156630854101,-27.5187307180012],[-58.8155729436463,-27.5184792874575],[-58.8151616576659,-27.5183899294035],[-58.8147974529362,-27.518394683494],[-58.8145410294152,-27.518492757997],[-58.8140684510277,-27.518368109721],[-58.8133767347047,-27.5181470791331],[-58.8126859825107,-27.5179846735402],[-58.8119341619079,-27.5178005059673],[-58.8110028619425,-27.5174698136745],[-58.8108526965131,-27.5172597590941],[-58.8105937597878,-27.5172044899024],[-58.8101632085052,-27.5171740087473],[-58.8097114640213,-27.5170851609055],[-58.809319755972,-27.5169549326337],[-58.8090004894512,-27.5169229997277],[-58.8082233894048,-27.5167391404485],[-58.8079632008756,-27.5166071978767],[-58.8078307989566,-27.5165547889895],[-58.8077453973312,-27.516591986199],[-58.8075506729828,-27.5164411482733],[-58.8071646913778,-27.5163514370767],[-58.8066250440782,-27.5161464388987],[-58.8062570864844,-27.5159211649784],[-58.805718400564,-27.5157747919052],[-58.8054549022744,-27.5154398984132],[-58.8043735226459,-27.5164508365176],[-58.803494439647,-27.5171478931208],[-58.8020447316144,-27.5185334823738],[-58.8013782202472,-27.5192367930261],[-58.8009938745798,-27.5198687829981],[-58.8000482043161,-27.5214508124434],[-58.7997410357247,-27.5218517456402],[-58.7972028829556,-27.5244512655615],[-58.7966014831492,-27.5251176263338],[-58.7958700861734,-27.5261916427602],[-58.7953754890541,-27.5272039562365],[-58.7949197457405,-27.5278052768858],[-58.7933646530659,-27.5292598061041],[-58.7925266030374,-27.5300013774748],[-58.7919119549461,-27.530478433492],[-58.7913668847591,-27.5308779053643],[-58.7913168794622,-27.5309146368122],[-58.7907644062802,-27.5311698537398],[-58.7900850153184,-27.531399637812],[-58.7888653956436,-27.5317040354139],[-58.7876807444114,-27.5319809074991],[-58.7864866249144,-27.5322984893186],[-58.7862245719365,-27.532365009521],[-58.7857002462243,-27.5324845186413],[-58.7837907750755,-27.5330007232817],[-58.7822286945438,-27.5334086978579],[-58.780449492067,-27.5338465020081],[-58.7794756087588,-27.5340168549498],[-58.7793744244963,-27.534018150344],[-58.7792783720925,-27.5340238908633],[-58.7791771878128,-27.5340251861143],[-58.7790760035262,-27.5340264812917],[-58.778974819233,-27.5340277763956],[-58.7788786941481,-27.5340290066761],[-58.7787775098416,-27.5340303016364],[-58.7787319769015,-27.5340308843445],[-58.7786762529011,-27.5340270865587],[-58.7785801278012,-27.5340283166327],[-58.7784788708598,-27.5340251014108],[-58.7783776139199,-27.5340218861148],[-58.7782814161978,-27.5340186060167],[-58.778180159261,-27.5340153905762],[-58.7780789023257,-27.5340121750617],[-58.7779826320098,-27.5340043847897],[-58.7778813024872,-27.533996659164],[-58.7777851047814,-27.5339933787205],[-58.7776837752742,-27.5339856529496],[-58.7775824457767,-27.5339779271041],[-58.777486102927,-27.5339656265177],[-58.7773847734532,-27.5339579005265],[-58.7772884306349,-27.533945599801],[-58.7771871011849,-27.5339378736641],[-58.7770907583981,-27.5339255727996],[-58.7769893564139,-27.5339133365483],[-58.7768930136625,-27.5339010355446],[-58.7767916117143,-27.5338887991468],[-58.7766951964525,-27.5338719880345],[-58.7765988537581,-27.5338596868235],[-58.7764973793302,-27.5338429402377],[-58.7764009641416,-27.5338261289171],[-58.7763045489784,-27.5338093175281],[-58.7762030746292,-27.5337925707229],[-58.7761066595176,-27.5337757591937],[-58.776010171914,-27.5337544376251],[-58.775913684344,-27.5337331159875],[-58.7758172693171,-27.5337163042529],[-58.7757207818101,-27.5336949824779],[-58.7756242943366,-27.5336736606342],[-58.7755278068967,-27.5336523387216],[-58.7754312469968,-27.5336265067674],[-58.7753347596279,-27.5336051847169],[-58.7752381998071,-27.5335793526244],[-58.7751366533054,-27.5335580950487],[-58.7750400935646,-27.5335322628142],[-58.7749485930674,-27.5335063659048],[-58.7748519609394,-27.5334760235609],[-58.7747554013263,-27.5334501911217],[-58.7746639009539,-27.5334242940181],[-58.7745672689655,-27.5333939514688],[-58.7744756962236,-27.5333635442616],[-58.7743790643333,-27.5333332015763],[-58.7742874916872,-27.53330279424],[-58.774190859895,-27.5332724514185],[-58.7740992873448,-27.533242043953],[-58.7740077148418,-27.5332116364247],[-58.773916069956,-27.5331767188568],[-58.7738244251251,-27.5331418012256],[-58.7737277211623,-27.5331069480915],[-58.7736360764429,-27.5330720303302],[-58.7716362371144,-27.5320600265464],[-58.7712841909879,-27.5318795660323],[-58.7705278524519,-27.532678610654],[-58.7692060242671,-27.5338727885231],[-58.7685971745795,-27.5344038023887],[-58.7680485972884,-27.5349069816038],[-58.7676888039886,-27.5351912343016],[-58.7625227933486,-27.53998427896],[-58.7583804016278,-27.5436184217081],[-58.7557260724716,-27.5460066836952],[-58.7543807755612,-27.5473363533835],[-58.7531890617952,-27.5490971214822],[-58.7526463815832,-27.5502993620819],[-58.7522871422323,-27.5515804838495],[-58.7521099176015,-27.5528502875666],[-58.7519702811404,-27.5555315346173],[-58.7534861688671,-27.5556928457519],[-58.7547826834483,-27.5551080995416],[-58.7557559446494,-27.5536117117834],[-58.7563769465113,-27.5525618411017],[-58.7565526502276,-27.5515175985324],[-58.7570686654159,-27.5505502488637],[-58.7581128814656,-27.5493822454991],[-58.7589989090196,-27.5490868437331],[-58.7602357681496,-27.5492110179435],[-58.7606618597077,-27.5495890465581],[-58.7610951045086,-27.5510496011999],[-58.7611637411851,-27.5515449310829],[-58.7619016263883,-27.5517972081125],[-58.7628735559207,-27.551175906766],[-58.7635428102583,-27.5506170829166],[-58.7640579515522,-27.5499158638733],[-58.7649412248168,-27.5494490452016],[-58.7666467406084,-27.5484981240727],[-58.7677320296041,-27.547690402023],[-58.7684675915725,-27.5474825623731],[-58.7692220887599,-27.5481405704473],[-58.7699869365134,-27.5494435005038],[-58.7706086715017,-27.5503422688149],[-58.7717142168427,-27.5507973084226],[-58.773198463474,-27.5508821238775],[-58.7745603697772,-27.5502828307616],[-58.7760770342452,-27.5498664929613],[-58.7771397912753,-27.550177687362],[-58.7780322841888,-27.5509150756404],[-58.7794329596776,-27.552408288994],[-58.780268224491,-27.5530471551429],[-58.7811196254711,-27.5537444504279],[-58.7821343489388,-27.5551523635562],[-58.7825648735859,-27.5561121673467],[-58.7829677728909,-27.5569279760182],[-58.7839587218023,-27.5574881345366],[-58.7853905124294,-27.557140446136],[-58.7868724053771,-27.556449272748],[-58.7880539742921,-27.5556536891504],[-58.7890492511825,-27.554919136487],[-58.7899361914485,-27.5543709184677],[-58.7905589736401,-27.5537629478286],[-58.7911304896701,-27.5531150377614],[-58.7929150856563,-27.5523702802167],[-58.7940511681828,-27.552518005212],[-58.794813545586,-27.5530269071237],[-58.7951406177442,-27.5535324083694],[-58.7954450340381,-27.554200592413],[-58.7955706653518,-27.5550785859864],[-58.7953305724282,-27.5558755999831],[-58.7949043524871,-27.557365179839],[-58.7949043599712,-27.5586101762396],[-58.7950977570351,-27.5592978381022],[-58.7963660085483,-27.5600979071251],[-58.7983746030599,-27.560049362251],[-58.7996343943071,-27.5597082649787],[-58.8011698439637,-27.5592011918758],[-58.8038370849151,-27.5585756601708],[-58.8053197859327,-27.5582496609308],[-58.8066409190586,-27.5579483017536],[-58.8081056169956,-27.5580690804161],[-58.8096879132022,-27.5594964537328],[-58.8106350490328,-27.5598449776513],[-58.8119129631531,-27.560301951215],[-58.8134968447186,-27.560281281177],[-58.815930857506,-27.5602494815137],[-58.8170916094868,-27.5600448470037],[-58.8186739216262,-27.5599294112958],[-58.8216023380518,-27.5598008219368],[-58.8230163902132,-27.5599175950627],[-58.8236344894828,-27.5599545896454],[-58.82453443944,-27.5589774572938],[-58.8255749257178,-27.5576240751718],[-58.8293970219168,-27.5552326826463],[-58.8315692629368,-27.5528539294537],[-58.8324762959327,-27.5510917754741],[-58.8335851236277,-27.5462460718465],[-58.8332530735026,-27.5430116919445],[-58.8320767741806,-27.53860660832],[-58.8307417774841,-27.5346952786043],[-58.8315176439368,-27.5262498226178],[-58.8326413645032,-27.5223105977369],[-58.8338181861731,-27.5197464654962],[-58.8345185455537,-27.5189613649704]],[[-58.7864261434335,-27.5429494562787],[-58.7898968660135,-27.5432070234613],[-58.79161529126,-27.5433833567857],[-58.7936823942913,-27.5435281031544],[-58.7937962702885,-27.5436845135422],[-58.7939552435338,-27.5438132764242],[-58.7938471560523,-27.5440131499235],[-58.7939053767988,-27.5441702786478],[-58.7941453051922,-27.5442979961369],[-58.7941687686071,-27.544496171285],[-58.793979946193,-27.5447106198894],[-58.7938516192876,-27.5449107546981],[-58.7937890677918,-27.5451100403057],[-58.7936548744065,-27.5452606311552],[-58.7934787377549,-27.5453215459303],[-58.7929966752457,-27.5452420606247],[-58.7926843658975,-27.5453317966554],[-58.7924963446452,-27.545595852575],[-58.7922671125679,-27.5458153311483],[-58.7922139450368,-27.5459693864228],[-58.7919921223989,-27.5460218668941],[-58.7919532551184,-27.5461216072399],[-58.7919049271441,-27.5462620673935],[-58.7919738517143,-27.5464551458419],[-58.7924280502899,-27.5466883634529],[-58.7927325145986,-27.5467385659559],[-58.7930767927755,-27.5470589059612],[-58.7931404403849,-27.5472385192225],[-58.7933232518791,-27.5472767576697],[-58.7934757047863,-27.5473153877329],[-58.7935359054845,-27.5475942842994],[-58.793556877438,-27.5476391222369],[-58.7935001899875,-27.5478879515331],[-58.7934885277727,-27.548104623576],[-58.7934460669127,-27.5482946279703],[-58.7933893789615,-27.548543457227],[-58.793331298632,-27.5487065980069],[-58.7931504628593,-27.5487901275109],[-58.7929634680978,-27.5488060732916],[-58.7927967126847,-27.5488217576705],[-58.7926369946381,-27.5489591444204],[-58.7925870552013,-27.5490003865253],[-58.792589252459,-27.5491356841383],[-58.7925624820697,-27.5493570619236],[-58.7925050593004,-27.5495607917012],[-58.7923552399442,-27.54968451786],[-58.7921381037939,-27.5497143840107],[-58.7919858675594,-27.549689282392],[-58.7919084315774,-27.5495955529274],[-58.7919220737128,-27.5495006487959],[-58.7920116140794,-27.5494047657664],[-58.7920531258828,-27.5491561327196],[-58.7920022342921,-27.5491387456444],[-58.7919462096302,-27.549116913886],[-58.7918241138435,-27.549077890728],[-58.791550880907,-27.5490814141554],[-58.7913502427043,-27.5491922619184],[-58.791125475611,-27.5493755943366],[-58.7909617923711,-27.5495806933767],[-58.7907516294685,-27.5494165001647],[-58.7901494426448,-27.5491084994476],[-58.7897091746645,-27.5487984104081],[-58.7892217464743,-27.5487009380921],[-58.7885896293947,-27.548731631065],[-58.7880905294234,-27.5488508268331],[-58.7876995847505,-27.5490859119769],[-58.7874949574848,-27.5495757189092],[-58.7872669486278,-27.5498718588362],[-58.7869147987041,-27.5500026927947],[-58.7868985237446,-27.5499352390161],[-58.7868165652187,-27.549561890596],[-58.7864361234144,-27.549508141347],[-58.786021697515,-27.5498562957158],[-58.7854764401594,-27.5502512390387],[-58.7850235982721,-27.55041493839],[-58.7846875997606,-27.5502929502846],[-58.7844738425487,-27.5502190109983],[-58.7846549475954,-27.5488995089269],[-58.784754261529,-27.5478426880494],[-58.7848330433556,-27.5467680872519],[-58.7849259096917,-27.5456256422164],[-58.7850238791463,-27.5447988929701],[-58.7851041163298,-27.5438144906465],[-58.7851825014974,-27.543028590689],[-58.7853113530972,-27.5428600327921],[-58.7864261434335,-27.5429494562787]]]}"
180,663,716,1379,331,340,178.23,8,"{""type"":""Polygon"",""coordinates"":[[[-58.7087163630202,-27.4858340436477],[-58.7095795420982,-27.4912862827549],[-58.7097222153183,-27.4923355959852],[-58.7099688390884,-27.49290997494],[-58.7103454279699,-27.4933835134707],[-58.7110044404949,-27.4941287496332],[-58.7113884325216,-27.4944262645322],[-58.7114392176741,-27.4944391728617],[-58.711494711588,-27.494429468197],[-58.7120284427639,-27.4942695271856],[-58.7122619288652,-27.4943207859987],[-58.7124147032864,-27.4943865708651],[-58.7125724656547,-27.4944477831507],[-58.713237005116,-27.494895213387],[-58.7137940124227,-27.4952582557661],[-58.7139060485518,-27.4953064967045],[-58.7140033311441,-27.4953819853471],[-58.7141295620716,-27.4953668971354],[-58.714245468071,-27.4953384030116],[-58.7145279958284,-27.4952898115034],[-58.7145155488083,-27.4954658941084],[-58.7144768351065,-27.4955791463274],[-58.7146060219077,-27.4964075791906],[-58.7148520036207,-27.4975909414672],[-58.7149505474402,-27.4977476118525],[-58.7152454360253,-27.4988221060287],[-58.7154755584226,-27.4999605519512],[-58.7156353378533,-27.5004773466304],[-58.7157914316285,-27.5004303114243],[-58.7158665297603,-27.5003797641249],[-58.7159060130235,-27.5003161230966],[-58.7159443767895,-27.5001803198562],[-58.7158735876159,-27.4998564009693],[-58.7156874211581,-27.4989429638168],[-58.7155004888431,-27.4979799146182],[-58.7153251441934,-27.497111453137],[-58.7151588691669,-27.4961752143686],[-58.714977214825,-27.4952256317552],[-58.715991975912,-27.4950958332742],[-58.7170620877678,-27.4949473003431],[-58.7181068383238,-27.4947945614558],[-58.7191313552537,-27.4946420648248],[-58.7189451733949,-27.4937286322096],[-58.7199848515959,-27.4935759423195],[-58.7210197495855,-27.4934413478654],[-58.7210866197665,-27.4935126966511],[-58.7215915294088,-27.4934523179617],[-58.7217276611996,-27.4934235674513],[-58.7218793163818,-27.4934171796792],[-58.7221463817131,-27.4933507203212],[-58.7234333762416,-27.4931633665086],[-58.7232567856088,-27.4922182448286],[-58.7230431110933,-27.4911653180295],[-58.7229441439222,-27.4903320091607],[-58.7227771142621,-27.4896754716939],[-58.7232685188152,-27.4897235186339],[-58.7232775805739,-27.4893309496679],[-58.7232194937179,-27.4885242005015],[-58.7245494828911,-27.4878536291493],[-58.724392698887,-27.4865564050508],[-58.724087017893,-27.4860910488932],[-58.7236716274421,-27.4857262928651],[-58.7229041354176,-27.4854876922171],[-58.722340129153,-27.4849984638364],[-58.7210811925964,-27.4847072913086],[-58.7203714436894,-27.484603292194],[-58.7200723839585,-27.4842370865865],[-58.7198260810583,-27.4836852770739],[-58.7194048156768,-27.4832664479372],[-58.7187693922899,-27.4830622798004],[-58.7173236043362,-27.4824621200175],[-58.7151082329718,-27.482137580582],[-58.7149574571257,-27.4818732888682],[-58.7147626362146,-27.4817042709266],[-58.714357238353,-27.4816551331288],[-58.7141041092627,-27.4816402069359],[-58.7128323281286,-27.4818227724411],[-58.71215936288,-27.4821332913014],[-58.711440043621,-27.4823902448536],[-58.7108518555935,-27.4826230277238],[-58.7102651980002,-27.4829550317832],[-58.7096734100602,-27.483282585477],[-58.7092752507735,-27.483702490105],[-58.7086920636537,-27.4842599962035],[-58.7085204245993,-27.4846094520728],[-58.7087163630202,-27.4858340436477]]]}"
181,937,998,1935,432,399,23.28,83,"{""type"":""Polygon"",""coordinates"":[[[-58.7199985124472,-27.4999859004586],[-58.7199612314847,-27.4992149811607],[-58.7198786329776,-27.4987829467446],[-58.7197902061813,-27.4983013633222],[-58.7196397654642,-27.4974100456132],[-58.7194634083935,-27.496478448886],[-58.7192876855271,-27.4955874428746],[-58.7191313552537,-27.4946420648248],[-58.7181068383238,-27.4947945614558],[-58.7170620877678,-27.4949473003431],[-58.715991975912,-27.4950958332742],[-58.714977214825,-27.4952256317552],[-58.7151588691669,-27.4961752143686],[-58.7153251441934,-27.497111453137],[-58.7155004888431,-27.4979799146182],[-58.7156874211581,-27.4989429638168],[-58.7158735876159,-27.4998564009693],[-58.7159443767895,-27.5001803198562],[-58.7167017921839,-27.5000897769486],[-58.7179378081057,-27.4998715233698],[-58.718937082937,-27.4997193384133],[-58.7189334268544,-27.4998096035277],[-58.7189698127687,-27.4998723078732],[-58.7190821360779,-27.4999385848155],[-58.7191889110171,-27.4999733532564],[-58.7192658298033,-27.5000400675826],[-58.7199985124472,-27.4999859004586]]]}"
228,573,603,1176,318,313,5.18,227,"{""type"":""Polygon"",""coordinates"":[[[-58.8025084244696,-27.4895586160882],[-58.8016754780742,-27.4899708729525],[-58.8013446436045,-27.4901555919124],[-58.8008433254914,-27.49012148324],[-58.7997595554821,-27.4900407772475],[-58.7997104549339,-27.4904428815285],[-58.7996748386282,-27.490741060916],[-58.7996288877511,-27.4910258412921],[-58.799588947402,-27.4913691854699],[-58.8002121576479,-27.491433297639],[-58.8004502133078,-27.4914527717736],[-58.8011187189447,-27.4915027610379],[-58.801766849284,-27.4915439891501],[-58.8022690441069,-27.4913209624302],[-58.8025803127371,-27.4911770926815],[-58.8032580354216,-27.490861570655],[-58.8030810208587,-27.4905526136694],[-58.8029508442964,-27.4903242454271],[-58.8028103335894,-27.4900824782797],[-58.8027167336096,-27.4899258100153],[-58.8025084244696,-27.4895586160882]]]}"
191,422,467,889,286,303,10.64,84,"{""type"":""Polygon"",""coordinates"":[[[-58.8312366248341,-27.4860664962142],[-58.8308006629235,-27.4869247828727],[-58.830823294338,-27.4873755697678],[-58.8308513560572,-27.4878488394066],[-58.8308791196891,-27.4883040695411],[-58.8308863404512,-27.4884347890577],[-58.8309019012801,-27.4887638760368],[-58.8309049605159,-27.4889487804475],[-58.8309246831775,-27.4892236824906],[-58.8309433613116,-27.4894354464313],[-58.8309479131013,-27.4897105480808],[-58.8327798837371,-27.4894608868525],[-58.8328398957826,-27.4894194987693],[-58.8328752202527,-27.4894145226075],[-58.8338949449502,-27.4892928260127],[-58.8343085735649,-27.4892242219498],[-58.8342506777103,-27.4887829228107],[-58.8342274597277,-27.4886027952502],[-58.8341873517155,-27.4883191409806],[-58.8341479166591,-27.4880760753822],[-58.8341244000873,-27.4878779083471],[-58.8340779651852,-27.4875176530888],[-58.8340148651698,-27.4870674006001],[-58.8340333738672,-27.4869634072825],[-58.8331231821047,-27.4866731744749],[-58.8325285379634,-27.4865005731191],[-58.8312366248341,-27.4860664962142]]]}"
192,361,431,792,221,205,8.43,94,"{""type"":""Polygon"",""coordinates"":[[[-58.8366884306851,-27.4872441459363],[-58.8366530322885,-27.4872446131755],[-58.8354564131176,-27.4873731735817],[-58.8353606307447,-27.4873924803499],[-58.8340779651852,-27.4875176530888],[-58.8341244000873,-27.4878779083471],[-58.8341479166591,-27.4880760753822],[-58.8341873517155,-27.4883191409806],[-58.8342274597277,-27.4886027952502],[-58.8342506777103,-27.4887829228107],[-58.8343085735649,-27.4892242219498],[-58.8343586203716,-27.4891919862872],[-58.8349844180882,-27.4891070504411],[-58.8355646268858,-27.4890182023909],[-58.8361553227398,-27.4889517677498],[-58.8369122246015,-27.4888425389877],[-58.8369748137377,-27.4892612204898],[-58.8370519347599,-27.4899458493845],[-58.8372044983831,-27.4909091537732],[-58.8378355845472,-27.4908376675083],[-58.8381132741325,-27.490806934232],[-58.8381257112235,-27.4903376431911],[-58.8381222281152,-27.4898234540987],[-58.8381254882032,-27.4891061883245],[-58.8381470287499,-27.4882713992773],[-58.83810949597,-27.4878388548897],[-58.8371806663929,-27.4879503600255],[-58.8371604386144,-27.4879506270983],[-58.8367971619346,-27.4880050422485],[-58.8367531135084,-27.4877891035051],[-58.8367187300468,-27.4875459721327],[-58.8366884306851,-27.4872441459363]]]}"
193,394,456,850,237,220,9.25,92,"{""type"":""Polygon"",""coordinates"":[[[-58.8343085735649,-27.4892242219498],[-58.8338949449502,-27.4892928260127],[-58.8328752202527,-27.4894145226075],[-58.8328398957826,-27.4894194987693],[-58.8329170436011,-27.4898019040925],[-58.8330395791699,-27.4904814269332],[-58.8331286359211,-27.4909719353264],[-58.8332176188743,-27.4914579337351],[-58.8342218913851,-27.491318394353],[-58.8353676100442,-27.4911679603333],[-58.8365081182303,-27.4910085640789],[-58.8372044983831,-27.4909091537732],[-58.8370519347599,-27.4899458493845],[-58.8369748137377,-27.4892612204898],[-58.8369122246015,-27.4888425389877],[-58.8361553227398,-27.4889517677498],[-58.8355646268858,-27.4890182023909],[-58.8349844180882,-27.4891070504411],[-58.8343586203716,-27.4891919862872],[-58.8343085735649,-27.4892242219498]]]}"
194,431,506,937,238,215,8.15,115,"{""type"":""Polygon"",""coordinates"":[[[-58.8381132741325,-27.490806934232],[-58.8378355845472,-27.4908376675083],[-58.8372044983831,-27.4909091537732],[-58.8365081182303,-27.4910085640789],[-58.8353676100442,-27.4911679603333],[-58.8342218913851,-27.491318394353],[-58.8332176188743,-27.4914579337351],[-58.833316791737,-27.4919483085982],[-58.8334059260166,-27.4924433264531],[-58.8334666365392,-27.4927492635113],[-58.8335109801233,-27.4929832427845],[-58.8345154154171,-27.4928527203579],[-58.8356406961685,-27.4926890205401],[-58.8367561581963,-27.4925434846891],[-58.838093906389,-27.4923814709666],[-58.8380987013947,-27.4920611384705],[-58.8381048449573,-27.4918219831455],[-58.8381143225226,-27.4914790345985],[-58.8381115505818,-27.4913121703786],[-58.8381132741325,-27.490806934232]]]}"
195,354,397,751,194,193,8.01,94,"{""type"":""Polygon"",""coordinates"":[[[-58.8328398957826,-27.4894194987693],[-58.8327798837371,-27.4894608868525],[-58.8309479131013,-27.4897105480808],[-58.8309622059588,-27.4899629673107],[-58.8312425443762,-27.490703567266],[-58.8313929505653,-27.4912338671514],[-58.8314859382984,-27.4916566624003],[-58.8315301278494,-27.4918816228458],[-58.8315851784448,-27.4921515487112],[-58.8316727374271,-27.4925518609873],[-58.8317001884156,-27.4926823140092],[-58.8317499587629,-27.492938776744],[-58.8319095351917,-27.4937170512565],[-58.8324043213516,-27.4936609161424],[-58.8330807183188,-27.493575321521],[-58.8335957318354,-27.4935189156973],[-58.8335109801233,-27.4929832427845],[-58.8334666365392,-27.4927492635113],[-58.8334059260166,-27.4924433264531],[-58.833316791737,-27.4919483085982],[-58.8332176188743,-27.4914579337351],[-58.8331286359211,-27.4909719353264],[-58.8330395791699,-27.4904814269332],[-58.8329170436011,-27.4898019040925],[-58.8328398957826,-27.4894194987693]]]}"
196,281,328,609,177,188,10.6,57,"{""type"":""Polygon"",""coordinates"":[[[-58.8309622059588,-27.4899629673107],[-58.8298514434512,-27.4900858400061],[-58.8291903099526,-27.4901757284605],[-58.8287056510892,-27.4902317185542],[-58.8275797110444,-27.490354772752],[-58.8276624202311,-27.4907686844653],[-58.8277957099718,-27.4914886693267],[-58.8278689772782,-27.4919433024693],[-58.8287926471231,-27.491822904227],[-58.8295396876219,-27.4917273768596],[-58.8296953402872,-27.4916576673182],[-58.829701366904,-27.4917162290568],[-58.8296972046723,-27.4917704139401],[-58.8298248553096,-27.4924543836473],[-58.8299298175241,-27.4929897936726],[-58.8300234729595,-27.4934531787659],[-58.8300871588632,-27.4939395121887],[-58.8305517531622,-27.493892802438],[-58.8314299201041,-27.4937729849174],[-58.8319095351917,-27.4937170512565],[-58.8317499587629,-27.492938776744],[-58.8317001884156,-27.4926823140092],[-58.8316727374271,-27.4925518609873],[-58.8315851784448,-27.4921515487112],[-58.8315301278494,-27.4918816228458],[-58.8314859382984,-27.4916566624003],[-58.8313929505653,-27.4912338671514],[-58.8312425443762,-27.490703567266],[-58.8309622059588,-27.4899629673107]]]}"
202,835,939,1774,468,408,20.55,86,"{""type"":""Polygon"",""coordinates"":[[[-58.838093906389,-27.4923814709666],[-58.8367561581963,-27.4925434846891],[-58.8356406961685,-27.4926890205401],[-58.8345154154171,-27.4928527203579],[-58.8335109801233,-27.4929832427845],[-58.8335957318354,-27.4935189156973],[-58.8337398514855,-27.4942793479166],[-58.8337789896995,-27.4945043739499],[-58.8338129213308,-27.4947204469137],[-58.8339074918852,-27.4952379466398],[-58.8340413524517,-27.4959894917866],[-58.8341813193378,-27.4968041078631],[-58.8342707618216,-27.4973171638544],[-58.8352346263201,-27.4971781481946],[-58.8358050614338,-27.4971074699985],[-58.836335111643,-27.4970418334125],[-58.8363653809529,-27.497036923016],[-58.8373698481359,-27.4969063784067],[-58.8381720936553,-27.4967830096131],[-58.8381605168824,-27.4963907203323],[-58.8381426840377,-27.4959263403952],[-58.8381351158955,-27.4954708464617],[-58.8381230151716,-27.4950469882048],[-58.8381118137721,-27.494677248018],[-58.8381041335225,-27.4939105080761],[-58.8381090405218,-27.4932924592274],[-58.8380927076175,-27.49291827591],[-58.8381027095499,-27.4926068963098],[-58.838093906389,-27.4923814709666]]]}"
203,370,412,782,183,169,8.52,92,"{""type"":""Polygon"",""coordinates"":[[[-58.82503755221,-27.4840413679915],[-58.8244832334729,-27.4847793955456],[-58.8242453369006,-27.4850757201414],[-58.8238483691555,-27.4855410310784],[-58.8234967615633,-27.4859967248504],[-58.8231151068015,-27.4864708549141],[-58.8227383572142,-27.4869358980464],[-58.8225056569909,-27.4872411735613],[-58.8230628081587,-27.4875947437335],[-58.8233541017965,-27.4877758721308],[-58.8236605673187,-27.4879568010358],[-58.8239619768297,-27.4881377955012],[-58.8242685929903,-27.4883277427222],[-58.8245444963681,-27.4884955376792],[-58.8248407029817,-27.4886675766376],[-58.8251420418944,-27.4888440584615],[-58.8249514373607,-27.4892480245085],[-58.8257618282272,-27.4893140777152],[-58.8257164611647,-27.4890169567103],[-58.8256167298995,-27.488490495443],[-58.8255011575795,-27.4876169061042],[-58.8254218055274,-27.4870991988716],[-58.8253402973001,-27.4864507050235],[-58.82503755221,-27.4840413679915]]]}"
204,419,396,815,197,202,5.59,146,"{""type"":""Polygon"",""coordinates"":[[[-58.8225056569909,-27.4872411735613],[-58.8224068943745,-27.4873868145564],[-58.8220303615609,-27.4878653856684],[-58.821733252852,-27.4882526988364],[-58.8216639395664,-27.4883438234771],[-58.8214162851654,-27.4886628256796],[-58.8207811556066,-27.4894109192518],[-58.8207071547889,-27.4895246590952],[-58.8218286344138,-27.4894378058662],[-58.8219955172524,-27.4894356207011],[-58.8225108168889,-27.4893972960988],[-58.8226875908589,-27.4893814479765],[-58.8230160019545,-27.4893591021189],[-58.8233493956081,-27.4893321793408],[-58.8236879204186,-27.4893096993716],[-58.8239756516076,-27.4892743518694],[-58.8243645977247,-27.4892421875815],[-58.824366532057,-27.4890527063168],[-58.8245146730752,-27.4891409809742],[-58.8249514373607,-27.4892480245085],[-58.8251420418944,-27.4888440584615],[-58.8248407029817,-27.4886675766376],[-58.8245444963681,-27.4884955376792],[-58.8242685929903,-27.4883277427222],[-58.8239619768297,-27.4881377955012],[-58.8236605673187,-27.4879568010358],[-58.8233541017965,-27.4877758721308],[-58.8230628081587,-27.4875947437335],[-58.8225056569909,-27.4872411735613]]]}"
205,722,806,1528,369,359,15.91,96,"{""type"":""Polygon"",""coordinates"":[[[-58.8257618282272,-27.4893140777152],[-58.8249514373607,-27.4892480245085],[-58.8245146730752,-27.4891409809742],[-58.824366532057,-27.4890527063168],[-58.8243645977247,-27.4892421875815],[-58.8239756516076,-27.4892743518694],[-58.8236879204186,-27.4893096993716],[-58.8233493956081,-27.4893321793408],[-58.8230160019545,-27.4893591021189],[-58.8226875908589,-27.4893814479765],[-58.8225108168889,-27.4893972960988],[-58.8219955172524,-27.4894356207011],[-58.8222228338482,-27.4906460645358],[-58.8225330707048,-27.4922839527633],[-58.82276264993,-27.4924027383204],[-58.8230373728418,-27.4924983776907],[-58.8233318047528,-27.4925621822301],[-58.8236814201301,-27.49259819769],[-58.8243833290284,-27.492525843539],[-58.824802183187,-27.4924662203444],[-58.8262556000995,-27.4922622052244],[-58.8263506442044,-27.4921978057267],[-58.8268147123591,-27.4921195396247],[-58.827071957496,-27.4920755640834],[-58.8278689772782,-27.4919433024693],[-58.8277957099718,-27.4914886693267],[-58.8276624202311,-27.4907686844653],[-58.8275797110444,-27.490354772752],[-58.8273374924303,-27.4903895300464],[-58.8264893908996,-27.4904908828798],[-58.8259389864863,-27.4905477264645],[-58.8258652074279,-27.4900615226581],[-58.8257958165107,-27.4895346635053],[-58.8257618282272,-27.4893140777152]]]}"
206,889,1057,1946,504,430,19.05,102,"{""type"":""Polygon"",""coordinates"":[[[-58.8219955172524,-27.4894356207011],[-58.8218286344138,-27.4894378058662],[-58.8207071547889,-27.4895246590952],[-58.8204365096601,-27.4899837971992],[-58.8201378193737,-27.4905831383705],[-58.8198190457864,-27.4911917633697],[-58.8197214629921,-27.4914095609647],[-58.8200829801152,-27.4930918936007],[-58.8201988270525,-27.4936767896306],[-58.8203299956437,-27.4942705067213],[-58.8204352114194,-27.4948239654761],[-58.8205657150673,-27.495377093154],[-58.8206585920813,-27.4957953873625],[-58.8206864765786,-27.4959529024027],[-58.8207622526588,-27.4962541380309],[-58.8207965309348,-27.4964927647518],[-58.8209274100232,-27.4970684411989],[-58.8209824383512,-27.4973383722039],[-58.8215435967133,-27.4970107549478],[-58.8220692756864,-27.4966790893695],[-58.8226051404855,-27.4963517993069],[-58.822885529294,-27.4961767131877],[-58.8232460915681,-27.4959554672994],[-58.8229324081308,-27.494416866126],[-58.822888383185,-27.4942009219853],[-58.8228269575773,-27.4938498801756],[-58.82259479137,-27.492653034394],[-58.8225330707048,-27.4922839527633],[-58.8222228338482,-27.4906460645358],[-58.8219955172524,-27.4894356207011]]]}"
207,322,356,678,170,162,6.53,104,"{""type"":""Polygon"",""coordinates"":[[[-58.8262556000995,-27.4922622052244],[-58.824802183187,-27.4924662203444],[-58.8243833290284,-27.492525843539],[-58.8236814201301,-27.49259819769],[-58.8233318047528,-27.4925621822301],[-58.8230373728418,-27.4924983776907],[-58.82276264993,-27.4924027383204],[-58.8225330707048,-27.4922839527633],[-58.82259479137,-27.492653034394],[-58.8228269575773,-27.4938498801756],[-58.822888383185,-27.4942009219853],[-58.823352091193,-27.4941001175342],[-58.823385708229,-27.4939914164689],[-58.8246219844294,-27.493808306753],[-58.8246953152912,-27.4942674518598],[-58.825129347557,-27.4942076283941],[-58.8265775057286,-27.4939901456018],[-58.8265444818809,-27.4938281886085],[-58.8264837895473,-27.4935222476686],[-58.826472707242,-27.4934637521187],[-58.8264003375838,-27.4930632365723],[-58.8263555622057,-27.492802195067],[-58.8263220180554,-27.492608668852],[-58.8262556000995,-27.4922622052244]]]}"
208,337,392,729,196,220,4.01,182,"{""type"":""Polygon"",""coordinates"":[[[-58.8265775057286,-27.4939901456018],[-58.825129347557,-27.4942076283941],[-58.8246953152912,-27.4942674518598],[-58.8247788358393,-27.4947309740793],[-58.8248623572034,-27.4951944961853],[-58.8249407476578,-27.4956535746444],[-58.8250294023794,-27.4961215400566],[-58.8257006159881,-27.4960270269508],[-58.8257278378341,-27.496143951775],[-58.8262473304108,-27.4960514270822],[-58.8262250909436,-27.4959299261248],[-58.8269415946009,-27.4958212800247],[-58.8268921314859,-27.4955828546674],[-58.8268257838734,-27.4952409014963],[-58.8266765034751,-27.4944715066143],[-58.8266103807722,-27.4941430828369],[-58.8265775057286,-27.4939901456018]]]}"
209,356,436,792,233,256,2.9,273,"{""type"":""Polygon"",""coordinates"":[[[-58.8269415946009,-27.4958212800247],[-58.8262250909436,-27.4959299261248],[-58.8262473304108,-27.4960514270822],[-58.8257278378341,-27.496143951775],[-58.8257006159881,-27.4960270269508],[-58.8250294023794,-27.4961215400566],[-58.8251129261913,-27.4965850618219],[-58.8251965252283,-27.4970530933465],[-58.8252750676754,-27.4975211911138],[-58.8257088888874,-27.4974478356455],[-58.8271718873358,-27.4972075962898],[-58.8271268099254,-27.4969285158789],[-58.827070947687,-27.4966089794585],[-58.8270093581488,-27.4962489205852],[-58.8269474711754,-27.4958708221711],[-58.8269415946009,-27.4958212800247]]]}"
210,396,510,906,242,234,7.07,128,"{""type"":""Polygon"",""coordinates"":[[[-58.822888383185,-27.4942009219853],[-58.8229324081308,-27.494416866126],[-58.8232460915681,-27.4959554672994],[-58.8234224962745,-27.4968372822687],[-58.8235057911109,-27.4972872756245],[-58.8236148943123,-27.4977685065195],[-58.8240790624646,-27.497694758251],[-58.8252750676754,-27.4975211911138],[-58.8251965252283,-27.4970530933465],[-58.8251129261913,-27.4965850618219],[-58.8250294023794,-27.4961215400566],[-58.8249407476578,-27.4956535746444],[-58.8248623572034,-27.4951944961853],[-58.8247788358393,-27.4947309740793],[-58.8246953152912,-27.4942674518598],[-58.8246219844294,-27.493808306753],[-58.823385708229,-27.4939914164689],[-58.823352091193,-27.4941001175342],[-58.822888383185,-27.4942009219853]]]}"
185,4,2,6,5,5,8972.28,0,"{""type"":""Polygon"",""coordinates"":[[[-58.8625646629467,-27.4682750681175],[-58.8618823048115,-27.4688976664487],[-58.8605423912922,-27.4701154573728],[-58.8595357563144,-27.4710040058989],[-58.8589777237837,-27.4715031380989],[-58.8582501985329,-27.4721488770713],[-58.8573537798335,-27.4729772988623],[-58.8564383230527,-27.4735759175243],[-58.8564600601367,-27.4736658439501],[-58.8565008220932,-27.4739855682767],[-58.8565746341619,-27.4741650164304],[-58.8565419065314,-27.4749277809079],[-58.856569864881,-27.4759919604915],[-58.8566251377482,-27.4768753429516],[-58.8567025824163,-27.4772712615326],[-58.8567740527199,-27.4773109054105],[-58.8568494786597,-27.4781895078698],[-58.8569594695066,-27.4790180300173],[-58.8569656843437,-27.4796900582099],[-58.857029766749,-27.4798921897101],[-58.8569617227936,-27.4806599357312],[-58.8569144341439,-27.48145898042],[-58.8567533912908,-27.4818084616578],[-58.856749405418,-27.4821738905809],[-58.8567508427128,-27.4822595768229],[-58.856594953458,-27.4832179486712],[-58.8566895765192,-27.4846375915743],[-58.8566710139086,-27.4847370770702],[-58.8565934463815,-27.4852388119157],[-58.8563480097225,-27.4853819214522],[-58.8563482366454,-27.4853954508558],[-58.8563484635683,-27.4854089802593],[-58.8563387282241,-27.4854316641834],[-58.8563338983708,-27.4854452610457],[-58.8563240873806,-27.4854634351677],[-58.8563192575243,-27.4854770320297],[-58.8563095221689,-27.485499715952],[-58.8563097490881,-27.4855132453557],[-58.8563101272872,-27.4855357943616],[-58.8563103542069,-27.4855493237652],[-58.8563055243459,-27.4855629206268],[-58.8563057512652,-27.4855764500304],[-58.8563009970423,-27.485594556693],[-58.8563012996012,-27.4856125958977],[-58.8563016021603,-27.4856306351023],[-58.856296847935,-27.4856487417648],[-58.8562970748541,-27.4856622711683],[-58.8562924719062,-27.485689397433],[-58.8562878689564,-27.4857165236975],[-58.8562881715147,-27.485734562902],[-58.8562883984336,-27.4857480923053],[-58.8562887009924,-27.4857661315098],[-58.8562940603426,-27.4857841032561],[-58.8562997222559,-27.4858201142063],[-58.8563101384043,-27.4858380184932],[-58.856320478915,-27.4858514129781],[-58.8563308194283,-27.4858648074622],[-58.856351349177,-27.4858825768258],[-58.8563616140539,-27.4858914615063],[-58.8563769357285,-27.4859002787248],[-58.8563975411359,-27.4859225578815],[-58.8564078816653,-27.4859359523589],[-58.8564181465516,-27.4859448370347],[-58.8564284870857,-27.4859582315103],[-58.8564389789153,-27.4859806455861],[-58.8564493951025,-27.4859985498604],[-58.8564546788446,-27.4860120117976],[-58.8564549057866,-27.4860255411991],[-58.8564500759264,-27.486039138065],[-58.8564503028681,-27.4860526674665],[-58.8564454730064,-27.4860662643323],[-58.8564406431436,-27.486079861198],[-58.8564358132798,-27.4860934580635],[-58.8564309834149,-27.4861070549288],[-58.8564210967428,-27.4861207192576],[-58.8564013233915,-27.4861480479134],[-58.8563915880028,-27.4861707318415],[-58.8563817769653,-27.4861889059684],[-58.8563669091147,-27.4862071475566],[-58.8563520412592,-27.4862253891434],[-58.8563422302108,-27.486243563268],[-58.8563374003288,-27.4862571601307],[-58.8563275892754,-27.4862753342545],[-58.856317778219,-27.4862935083776],[-58.8563081184441,-27.4863207021016],[-58.8562933262062,-27.4863434534838],[-58.8562887232394,-27.4863705797472],[-58.8562889501645,-27.4863841091494],[-58.8562842715539,-27.486406725612],[-58.8562794416588,-27.4864203224731],[-58.8562695549417,-27.4864339867929],[-58.8562647250437,-27.4864475836536],[-58.8562650276077,-27.4864656228564],[-58.8562602733488,-27.4864837295177],[-58.8562605002716,-27.4864972589198],[-58.8562557460109,-27.486515365581],[-58.8562560485743,-27.4865334047837],[-58.8562513699525,-27.4865560212455],[-58.8562517481565,-27.4865785702488],[-58.8562519750791,-27.4865920996508],[-58.8562523532839,-27.486614648654],[-58.8562476746589,-27.4866372651156],[-58.8562430716731,-27.4866643913776],[-58.8562433742363,-27.4866824305801],[-58.8562387712482,-27.4867095568421],[-58.8562440550046,-27.4867230187856],[-58.8562493387623,-27.4867364807289],[-58.8562597549984,-27.4867543850134],[-58.8562753793591,-27.4867812414384],[-58.8562909280845,-27.4868035880608],[-58.8563114580108,-27.4868213574197],[-58.8563167417821,-27.4868348193596],[-58.8563220255547,-27.4868482812991],[-58.8563275362632,-27.4868752726393],[-58.8563227820013,-27.4868933793021],[-58.8563179520934,-27.4869069761645],[-58.8563181790273,-27.4869205055653],[-58.8563083679187,-27.4869386796891],[-58.8562936512499,-27.4869659408738],[-58.8562687452388,-27.4869888271769],[-58.8562587828314,-27.486997981697],[-58.8562488204224,-27.4870071362165],[-58.8562236874693,-27.4870164931111],[-58.8562137250557,-27.4870256476282],[-58.8561787053162,-27.4870486688322],[-58.8561791591528,-27.4870757276355],[-58.8561744804991,-27.4870983440948],[-58.8561747830567,-27.4871163832969],[-58.8561699531223,-27.4871299801551],[-58.8561651231868,-27.4871435770132],[-58.8561602932501,-27.4871571738711],[-58.8561507090123,-27.4871888773871],[-58.8561458790723,-27.4872024742447],[-58.8561411247695,-27.4872205809027],[-58.8561416542388,-27.4872521495063],[-58.8561470136524,-27.4872701212523],[-58.8561473162078,-27.4872881604542],[-58.8561475431245,-27.4873016898556],[-58.8561477700413,-27.487315219257],[-58.856143167013,-27.4873423455159],[-58.8561436208465,-27.4873694043185],[-58.8561388665379,-27.4873875109763],[-58.8561340365893,-27.4874011078336],[-58.8561294335552,-27.487428234092],[-58.8561248305193,-27.4874553603503],[-58.8561200762047,-27.4874734670076],[-58.8561152462506,-27.4874870638644],[-58.8561108701241,-27.4875277195235],[-58.8561061914428,-27.4875503359808],[-58.8561013614842,-27.4875639328372],[-58.8560866446895,-27.4875911940043],[-58.8560818903642,-27.4876093006606],[-58.8560770604003,-27.4876228975163],[-58.8560772873117,-27.4876364269175],[-58.8560779680467,-27.4876770151212],[-58.8560781949587,-27.4876905445224],[-58.8560784218709,-27.4877040739235],[-58.8560837056632,-27.48771753587],[-58.8560941219755,-27.4877354401613],[-58.8561044626527,-27.4877488346514],[-58.8561148033324,-27.4877622291406],[-58.8561354846995,-27.4877890181161],[-58.8561990417219,-27.4879595810195],[-58.8562018405304,-27.4881264436138],[-58.8562726371046,-27.4881254991557],[-58.8562133915701,-27.4882119948883],[-58.856056703233,-27.4882185958794],[-58.8560690862045,-27.48835375497],[-58.8560748995077,-27.4883987855137],[-58.8558796463864,-27.4885186709687],[-58.855864475635,-27.4885188733155],[-58.8558112696837,-27.488663928855],[-58.8558132360598,-27.4887811836654],[-58.8557328545766,-27.4888138314036],[-58.8556820683474,-27.4891032005197],[-58.8556108271959,-27.4893793099845],[-58.8555775459267,-27.4895060564846],[-58.8554390512668,-27.4896928465771],[-58.8552954235567,-27.4898751941802],[-58.8551284005954,-27.490170623814],[-58.8550840217159,-27.4902388776566],[-58.854955639365,-27.4904255324862],[-58.8547888415149,-27.4907344911808],[-58.854610348742,-27.4912511028231],[-58.8541843539735,-27.4914868318891],[-58.8538625211389,-27.4919016042449],[-58.8538059973334,-27.4924526762187],[-58.8538610265593,-27.4927180807535],[-58.8540687523255,-27.4930400909517],[-58.8540575862843,-27.4932793126388],[-58.8539055756739,-27.4935655192964],[-58.8538939558885,-27.4937776821611],[-58.8535463715638,-27.4938635080086],[-58.8539268682295,-27.4939306110893],[-58.854194898214,-27.4939270391394],[-58.854183732476,-27.4941662607987],[-58.8540290759838,-27.4942946245582],[-58.8539191965681,-27.4952839558671],[-58.8540042755592,-27.4958331406233],[-58.8536455937025,-27.4961626984571],[-58.852899541577,-27.4969214314385],[-58.8519813759483,-27.497068982028],[-58.8515636566009,-27.4974985585677],[-58.8508826494221,-27.497913594025],[-58.8504139715932,-27.4983212912786],[-58.8498739587519,-27.4986983600095],[-58.8495465850695,-27.4987839077004],[-58.8490583473422,-27.4992324580272],[-58.8488752931487,-27.4994784750488],[-58.8486434800785,-27.4995311748715],[-58.8484046417653,-27.4997689110252],[-58.8480993018779,-27.4999624221988],[-58.8479756531476,-27.5001309650305],[-58.8479474933645,-27.5002621527346],[-58.8477276765402,-27.5004274620869],[-58.8474069351685,-27.5006076439682],[-58.8471128358942,-27.5008686660344],[-58.8469290216529,-27.5010695826354],[-58.8465934056686,-27.5012680034993],[-58.8464289165055,-27.5014145331501],[-58.8461675808505,-27.5015172398769],[-58.8459874664769,-27.5016369115208],[-58.8458815590966,-27.5016563602527],[-58.8457984408248,-27.5018288742542],[-58.8456300210633,-27.5020431174201],[-58.8454008345144,-27.5022536557939],[-58.8451476382396,-27.5025411961994],[-58.8448677812915,-27.5030501198244],[-58.8447450269995,-27.5032727779543],[-58.8445791605596,-27.5036403538723],[-58.8444030273363,-27.5039990441231],[-58.8442361810862,-27.5043079920482],[-58.8440544616913,-27.5046351802539],[-58.8438341594909,-27.505075650163],[-58.8435575439426,-27.5054762688418],[-58.8432208348601,-27.5059137699684],[-58.8429440647797,-27.5063053679496],[-58.842776985792,-27.5066007849314],[-58.842567715177,-27.5067930118876],[-58.8422712354172,-27.5072164454913],[-58.8420786388398,-27.5074986672674],[-58.8418546425725,-27.5077181531823],[-58.8414576765859,-27.5081835133052],[-58.8411731334971,-27.5084128215024],[-58.8411452644353,-27.5085620474805],[-58.8407421084166,-27.5089598253787],[-58.8404201013403,-27.5093700607858],[-58.840301563827,-27.5095430405592],[-58.8402433458093,-27.5096926679848],[-58.8396344271539,-27.5104946284828],[-58.839501238591,-27.5106993771849],[-58.8388822682331,-27.5115059784524],[-58.8387315778275,-27.5115711224665],[-58.8388094733994,-27.5116918846619],[-58.838781150504,-27.5118140513231],[-58.8386343598426,-27.5121137063622],[-58.83856523938,-27.5125205940884],[-58.8383148524533,-27.5129794971809],[-58.8380976956671,-27.5133071468305],[-58.8380316062594,-27.5135922021018],[-58.8379163599198,-27.5139636126512],[-58.8378081204588,-27.514452211845],[-58.8375473101911,-27.5148932081852],[-58.8373932803893,-27.51506214392],[-58.8373812542944,-27.5152517572995],[-58.8371133972828,-27.5158777896733],[-58.8367987761739,-27.5161255303801],[-58.8366925532633,-27.516126933507],[-58.8366963751385,-27.516356934902],[-58.8364741491148,-27.5166846492383],[-58.8364346191725,-27.5170460370162],[-58.8361371909747,-27.51741534146],[-58.8359014736897,-27.5175402461608],[-58.8357109412346,-27.5179487357057],[-58.8354102878905,-27.5181241159629],[-58.8352163828565,-27.5183296624281],[-58.8345185455537,-27.5189613649704],[-58.8338181861731,-27.5197464654962],[-58.8326413645032,-27.5223105977369],[-58.8315176439368,-27.5262498226178],[-58.8307417774841,-27.5346952786043],[-58.8320767741806,-27.53860660832],[-58.8332530735026,-27.5430116919445],[-58.8335851236277,-27.5462460718465],[-58.8324762959327,-27.5510917754741],[-58.8315692629368,-27.5528539294537],[-58.8293970219168,-27.5552326826463],[-58.8255749257178,-27.5576240751718],[-58.82453443944,-27.5589774572938],[-58.8236344894828,-27.5599545896454],[-58.82274881059,-27.5608773995384],[-58.8215545295803,-27.56364917542],[-58.8198781691365,-27.5678842535853],[-58.8200774759116,-27.5716797470313],[-58.8221259241964,-27.5752570192658],[-58.8248492834979,-27.5773954614529],[-58.8285352644366,-27.5786596089419],[-58.8287772826738,-27.5801269407523],[-58.8277879710355,-27.5839651235435],[-58.8262235919916,-27.5867102328487],[-58.8247313198646,-27.5876996786037],[-58.8231687929084,-27.5878104261491],[-58.8203615852515,-27.5894982224048],[-58.8193384000247,-27.5913069369629],[-58.8173940583038,-27.5955906084962],[-58.8166915700404,-27.6008864661409],[-58.8174097083912,-27.6060509480005],[-58.8186705698857,-27.6085063418755],[-58.8211258872022,-27.6106167595036],[-58.8232213570022,-27.6133137507257],[-58.8236374850423,-27.6161184985552],[-58.8233471617026,-27.6169342558103],[-58.8230675919497,-27.6183994237165],[-58.8208332814117,-27.621090134429],[-58.8183786106605,-27.6236303346751],[-58.8174974690991,-27.624553063441],[-58.8159184695356,-27.6255390559762],[-58.8142745842325,-27.6265845205135],[-58.8127623159471,-27.6276282460642],[-58.8120105045018,-27.6287206615798],[-58.8113310393847,-27.630209078025],[-58.8111097183142,-27.6321470981424],[-58.8109612606456,-27.6348194246874],[-58.8115148953162,-27.6373743197417],[-58.8119250896488,-27.6389071374619],[-58.8120759916449,-27.640380191739],[-58.8115305719483,-27.6423224463322],[-58.81075353227,-27.6440421855321],[-58.8068371795928,-27.648301853322],[-58.8057887957221,-27.6498536944432],[-58.8044524898433,-27.6517656295004],[-58.8040034713284,-27.6546538684027],[-58.8044617082553,-27.655103492127],[-58.8044803718153,-27.6562399671917],[-58.805007766832,-27.6571984068273],[-58.8053399654943,-27.6579924881731],[-58.8059481689797,-27.6592430714702],[-58.8062613308677,-27.6598028374354],[-58.8070461085439,-27.6606992722713],[-58.8081459681207,-27.6616547417586],[-58.8092570632161,-27.663291182033],[-58.8096042473754,-27.6649917206088],[-58.8102079119495,-27.6665761374022],[-58.8102971759111,-27.6679958639192],[-58.8105052606072,-27.669247138777],[-58.8105983250511,-27.6708968639204],[-58.8107455605902,-27.6721444221716],[-58.8110853648616,-27.6733939731634],[-58.8114204156719,-27.6743548960438],[-58.8116855216262,-27.6753753725616],[-58.8128366065546,-27.6757392165882],[-58.813449995034,-27.6757582520146],[-58.8141141143998,-27.6757811310691],[-58.8154416767311,-27.6754795600307],[-58.8166847487833,-27.6749715897954],[-58.8172517108128,-27.6746348676047],[-58.8178185199485,-27.6742891236911],[-58.8182033885411,-27.6733593675307],[-58.8188006413525,-27.6727109996573],[-58.819211810626,-27.6721462668604],[-58.8198173133503,-27.67138501772],[-58.8204576112486,-27.6708894434155],[-58.8212693237954,-27.6706487258054],[-58.8217530558907,-27.6704889997865],[-58.8221812920615,-27.67034353435],[-58.8226045365302,-27.6702026440495],[-58.8230222652907,-27.6700347605663],[-58.8235608117929,-27.6698201780605],[-58.8242391622509,-27.6694819624119],[-58.824701424179,-27.6692503371208],[-58.8255355916514,-27.6688378909882],[-58.8278238537099,-27.6678198660897],[-58.8307357175615,-27.6665274320064],[-58.8324823070025,-27.6634144843502],[-58.8337184993878,-27.6619005637356],[-58.8354866525129,-27.6597841699175],[-58.8375974920207,-27.6572617558455],[-58.8390632141387,-27.6549418363079],[-58.8405275207518,-27.6522385089581],[-58.8421980357,-27.6491490145615],[-58.8437460245904,-27.6469136608242],[-58.8442924843501,-27.6456704497171],[-58.8457707930987,-27.6441171233929],[-58.8472541244381,-27.6425637155226],[-58.8483019160732,-27.6410161005287],[-58.8495660407587,-27.6390821802361],[-58.8510441886086,-27.6375288042157],[-58.8529554925808,-27.6358343034566],[-58.8545932589772,-27.6344411450502],[-58.8561171099282,-27.6332028581203],[-58.8586926749628,-27.6312648317484],[-58.861161408947,-27.6296033480178],[-58.8640398112385,-27.6279137628358],[-58.8667363963109,-27.6259604361003],[-58.8698149201641,-27.6238395253081],[-58.8713507243197,-27.6224295123853],[-58.8751850767219,-27.6189089910966],[-58.877884333763,-27.611497472569],[-58.8799103366818,-27.60589480263],[-58.8781441150992,-27.5985256684744],[-58.8771973278858,-27.5946637751577],[-58.8722101577563,-27.5833280255494],[-58.8714749708152,-27.5805773707634],[-58.8707123465643,-27.5785939044501],[-58.8702431431982,-27.576299750238],[-58.8697738857769,-27.5740010830441],[-58.8693047272746,-27.5717069222846],[-58.8698824369114,-27.5678650140008],[-58.8704814636247,-27.564983604138],[-58.8716872297662,-27.5599784780007],[-58.8723006328133,-27.5582471068179],[-58.8741897633396,-27.5553437768231],[-58.8755464518732,-27.5514913352662],[-58.8763274128171,-27.5489051557017],[-58.878596177772,-27.5442374551597],[-58.8785749320519,-27.5435836845985],[-58.8795967088841,-27.5411791734371],[-58.879818799681,-27.5390651412047],[-58.879794847649,-27.5376581128151],[-58.8797629910693,-27.5357865841975],[-58.8799781586433,-27.5329689677877],[-58.8799502964035,-27.5313319430589],[-58.8793693945997,-27.5278214132438],[-58.8792451593356,-27.5225996405712],[-58.8797853563223,-27.518961179756],[-58.8798148247063,-27.5162317734727],[-58.8799337947817,-27.5125178107913],[-58.8795170986608,-27.5085404411753],[-58.8791936247967,-27.5055812405793],[-58.8786812072991,-27.5025163311816],[-58.8780016207438,-27.4997333423861],[-58.8765667921733,-27.4965590790961],[-58.8751708134617,-27.4935827472779],[-58.8739658727528,-27.4902339405763],[-58.872135842612,-27.4864063660183],[-58.871090532675,-27.482915542985],[-58.8698650325893,-27.4801308129895],[-58.8676202458291,-27.4750817968265],[-58.8650019615513,-27.471264677378],[-58.8625646629467,-27.4682750681175]]]}"
186,18,19,37,10,10,4981.01,0,"{""type"":""Polygon"",""coordinates"":[[[-58.7035263679914,-27.3718851520445],[-58.7064624210809,-27.3725620314243],[-58.7104581699683,-27.3744573879862],[-58.7131396938507,-27.375989836355],[-58.7143529386748,-27.3773327690756],[-58.7164717888091,-27.3790705483098],[-58.7186795562875,-27.3806718653473],[-58.720827812642,-27.3813626441003],[-58.7227628841256,-27.3813387627146],[-58.7247630600615,-27.3816027573907],[-58.72640968602,-27.3828545086768],[-58.7286846192184,-27.3835616395661],[-58.730722746655,-27.3846370652797],[-58.7308356734656,-27.3860476222256],[-58.7320389941903,-27.3873814892906],[-58.7338943246958,-27.3896906485855],[-58.7352501342859,-27.3907519266922],[-58.7372197369457,-27.3916341276859],[-58.739388609707,-27.3932987342279],[-58.7396170945943,-27.3953032931416],[-58.7399562688191,-27.3966298156345],[-58.740003958456,-27.3983840105652],[-58.741564252848,-27.3995825105661],[-58.7427194847991,-27.4013769984676],[-58.7438377156469,-27.4017780327033],[-58.7450746899476,-27.4039458906459],[-58.7457589812796,-27.4047132196588],[-58.7474142513623,-27.4055134896256],[-58.748088022539,-27.4065741537537],[-58.749352510593,-27.4072710337839],[-58.7500451040847,-27.4082412308732],[-58.7512745394235,-27.4083160134087],[-58.7523512300465,-27.4086408101834],[-58.7536431716453,-27.409472634332],[-58.7549868166816,-27.4106962518514],[-58.7551251268197,-27.4111320775885],[-58.7549663629619,-27.4126001508845],[-58.7558439647808,-27.4156746215181],[-58.7561225340055,-27.4166680421625],[-58.7578807395724,-27.4182066834451],[-58.7588508274639,-27.4194530117665],[-58.7589428624941,-27.420475844744],[-58.7604630096662,-27.4232534632379],[-58.7619374719003,-27.4253775468746],[-58.7638734470103,-27.4269544542651],[-58.7660734719623,-27.4276483464232],[-58.7679924393531,-27.4281517971863],[-58.7707586228981,-27.4285226615395],[-58.7724583089768,-27.4276394586358],[-58.7754680429994,-27.4274342393444],[-58.7765674403643,-27.4288456909354],[-58.7776472987378,-27.4302979804798],[-58.778720034404,-27.4316195336529],[-58.7792085885864,-27.4315050333559],[-58.7800197462959,-27.4329066013239],[-58.7806932322287,-27.434549003474],[-58.7812315194223,-27.4353270278942],[-58.7813973985448,-27.435582031129],[-58.7816312356291,-27.4359760044923],[-58.7821586300363,-27.436704543601],[-58.7826484007907,-27.4372937225233],[-58.7833052031712,-27.4378942943816],[-58.7836337883662,-27.4382058540393],[-58.7838147695148,-27.4384561496629],[-58.7840485978685,-27.4385343524703],[-58.7843401341234,-27.4387426330766],[-58.7847737155034,-27.43898066993],[-58.7852836751835,-27.4389380483151],[-58.7856935540114,-27.438959860843],[-58.7861371462506,-27.4388774883277],[-58.7864285418098,-27.4390767443075],[-58.786480180153,-27.4391437462132],[-58.7865835296868,-27.4392822599627],[-58.7867312833927,-27.4393525400646],[-58.7868443798514,-27.4394683739024],[-58.7870429332101,-27.4398673005027],[-58.7871212604644,-27.440335433161],[-58.7873717470031,-27.4408194007087],[-58.7874354594374,-27.4410080425519],[-58.7878686172783,-27.4418460289401],[-58.7881903172037,-27.4423561462905],[-58.788461688177,-27.4428804417342],[-58.7886702913993,-27.4432747254555],[-58.7891080866699,-27.4440855819638],[-58.7895447967102,-27.4448287867672],[-58.7899347787317,-27.4454959045933],[-58.791068111214,-27.4467940163599],[-58.7911093542817,-27.446843106218],[-58.7919801580073,-27.4478513749584],[-58.7927035950576,-27.4485006605086],[-58.7933345650701,-27.4493721677776],[-58.7941360215167,-27.4504670216959],[-58.7943703022298,-27.450883519094],[-58.7945316187915,-27.4511656285872],[-58.7954577331461,-27.4521506054127],[-58.7958540161335,-27.4525785440215],[-58.7962982135043,-27.4531547235991],[-58.7970296282264,-27.4536685537575],[-58.7972875955518,-27.4539854996838],[-58.7974527363893,-27.4541908703644],[-58.7979449433236,-27.4546085424142],[-58.7985292571229,-27.4547814337922],[-58.7990420589355,-27.4552213902628],[-58.7996068120814,-27.45574638061],[-58.8002554641156,-27.4564552310933],[-58.8009359225611,-27.4569426323896],[-58.8010382079703,-27.4570134840205],[-58.8015038428335,-27.4573502897688],[-58.8021270128248,-27.4577346751194],[-58.8026554430298,-27.4578902278865],[-58.8031694414779,-27.4580910745072],[-58.8035796213257,-27.4584376127755],[-58.8038811375954,-27.4586321867969],[-58.8039288415604,-27.4587668958644],[-58.8042633993618,-27.4588166920908],[-58.8047475846718,-27.4590494952048],[-58.8054381013878,-27.4592209797223],[-58.8059831065363,-27.4594620115647],[-58.8064349047938,-27.4595689234741],[-58.8069272968497,-27.4596843289055],[-58.8078987561945,-27.460028079822],[-58.8084825232058,-27.4601648476501],[-58.8094228937466,-27.4601526308024],[-58.8098947731954,-27.460250248505],[-58.8101472663105,-27.4602289227198],[-58.8105605853557,-27.460146863746],[-58.8109553024098,-27.4601642851058],[-58.8112872861891,-27.4600562164711],[-58.8115881559176,-27.460210183508],[-58.8118616826711,-27.4602382007528],[-58.8120034649611,-27.4602498884133],[-58.8123884397165,-27.4602899869098],[-58.8128370733611,-27.4602029506656],[-58.813205810883,-27.4598688545976],[-58.8136959571398,-27.4595376871576],[-58.8141634801878,-27.4593692047629],[-58.8148580236281,-27.4588594456627],[-58.8149829381702,-27.4587675998053],[-58.8150128289812,-27.4587401448763],[-58.8154600071283,-27.4582561614886],[-58.815469822868,-27.458237989971],[-58.8156536304037,-27.4580371144512],[-58.8157678712375,-27.4576025798081],[-58.8156741359087,-27.4574368992806],[-58.8156714756599,-27.4572745420743],[-58.8156784832576,-27.4570849934902],[-58.8157316562123,-27.4569354409248],[-58.8160641425218,-27.4568589309968],[-58.8162444434768,-27.4567528291059],[-58.816426074716,-27.4567279055736],[-58.8165935002363,-27.4567618086305],[-58.8167951318754,-27.4567230910509],[-58.8170425593248,-27.4567018191595],[-58.8171479868639,-27.4566553345999],[-58.8171621921787,-27.4565965077351],[-58.8173138592738,-27.4565945284896],[-58.8174598790558,-27.4565565357148],[-58.8177322138791,-27.4565123831155],[-58.8178579371521,-27.4564701439858],[-58.8179426239606,-27.4563923534149],[-58.8180931068523,-27.4563182146616],[-58.8182595701621,-27.4562934868049],[-58.818381051439,-27.4563009223145],[-58.8185217928299,-27.456249464728],[-58.8186988851157,-27.456256173723],[-58.8187952366449,-27.4562729588358],[-58.8188819212351,-27.4563169354386],[-58.8189370141346,-27.4562846396503],[-58.8190118110013,-27.456220510286],[-58.8191174592738,-27.4561875540377],[-58.8193445886165,-27.4561620323852],[-58.8193851070121,-27.4561660138904],[-58.8194966251711,-27.4561826003602],[-58.8195921621557,-27.4561497758715],[-58.8196978101625,-27.4561168191941],[-58.8198334950934,-27.4560654263839],[-58.819838254387,-27.4560473206647],[-58.8198353660155,-27.4558714340633],[-58.8199107545751,-27.4558433835535],[-58.8199932724936,-27.4559415444822],[-58.8200638277336,-27.4559270896998],[-58.8201649383582,-27.4559257681445],[-58.8202458268529,-27.4559247108475],[-58.8203508076912,-27.4558511644882],[-58.8203743073539,-27.4557425961764],[-58.8205255284809,-27.4557135540225],[-58.8206217315487,-27.4557213180594],[-58.8206956208328,-27.4559098089549],[-58.8207417874692,-27.4559498032535],[-58.8207727875423,-27.4559899958412],[-58.8207736026321,-27.4560396048564],[-58.8207741213268,-27.4560711742295],[-58.8207595475087,-27.4561074518184],[-58.8207500292212,-27.4561436633048],[-58.8207509925037,-27.4562022921403],[-58.8207367150566,-27.456256609369],[-58.8207274190459,-27.4563063505853],[-58.8207483081244,-27.4563466753734],[-58.8207733635669,-27.4563328151319],[-58.8207985672051,-27.4563279747065],[-58.820838641072,-27.4563048963222],[-58.820858196327,-27.4562640427105],[-58.8208713621605,-27.4561420768205],[-58.820886010049,-27.4561103091318],[-58.8209056393608,-27.4560739654249],[-58.8209306947223,-27.4560601051585],[-58.8209561947173,-27.4560733043477],[-58.8209767132896,-27.4560910795513],[-58.8209871207944,-27.4561089869716],[-58.8209926950898,-27.4561404902306],[-58.8210236953081,-27.4561806827544],[-58.8210531392183,-27.456126167167],[-58.821056490207,-27.4560223731312],[-58.8211521747575,-27.4559985674194],[-58.8212676366698,-27.4559474377106],[-58.8212408025517,-27.4558530602099],[-58.8213157459736,-27.4557979495014],[-58.8214776709224,-27.4558048533507],[-58.8215643560978,-27.4558488282517],[-58.8217210773213,-27.455846778127],[-58.8218381699086,-27.4558948659396],[-58.821970132583,-27.4559247155838],[-58.8221268538783,-27.4559226649974],[-58.8222180758052,-27.4559350039742],[-58.8223400758804,-27.4559740053814],[-58.8223679492567,-27.4561315213113],[-58.8224265390029,-27.4560044500023],[-58.822650910795,-27.4561187962523],[-58.822828522082,-27.4561570693284],[-58.8230121534944,-27.4562539047496],[-58.8231911748677,-27.456377865527],[-58.8235173270154,-27.4565314755794],[-58.8237776093665,-27.456676925792],[-58.8239864459845,-27.4567689188713],[-58.8241891880034,-27.4567978392281],[-58.8242812274922,-27.4568597857177],[-58.8244496203104,-27.4569523079068],[-58.8246070854224,-27.4569953534623],[-58.8246642561343,-27.4570893326766],[-58.8247606833121,-27.4571106234784],[-58.8248322039976,-27.4571547949696],[-58.8250147245755,-27.4571839790829],[-58.82520178083,-27.4571815273968],[-58.8252768715805,-27.4571354344146],[-58.8253122605828,-27.4571349705355],[-58.8254286873111,-27.4571424660941],[-58.8254564168503,-27.4572909613563],[-58.8256442162524,-27.4573336080421],[-58.825792982981,-27.4574624728109],[-58.8260472485893,-27.4575493561437],[-58.8263206963217,-27.4575728352289],[-58.8265751112242,-27.4576687373533],[-58.8265787548279,-27.4572762438638],[-58.8266800150023,-27.4572839373095],[-58.8267074487721,-27.4577211318061],[-58.8270164348714,-27.457753165032],[-58.8273399929204,-27.457748919389],[-58.8275926238328,-27.4577365821735],[-58.8277451842644,-27.457788710197],[-58.8279393799468,-27.4579124653838],[-58.8282743144668,-27.4579847529539],[-58.8285409961915,-27.4579045665131],[-58.8287530335594,-27.4578837384999],[-58.8289641775707,-27.4578087915035],[-58.8291249142866,-27.4577435280736],[-58.8293076599856,-27.4577862361162],[-58.8293808208071,-27.4579296226839],[-58.8294856557262,-27.4581537886379],[-58.8295775502072,-27.4582067116403],[-58.8297799234787,-27.4582130742157],[-58.8299466095823,-27.4582018620344],[-58.8302396857912,-27.4581889884559],[-58.8303922479267,-27.4582411134834],[-58.8305758889067,-27.4583379384064],[-58.8307599772767,-27.4584618223725],[-58.8308814611111,-27.4584692468126],[-58.8309833186665,-27.4585130161238],[-58.831005404226,-27.4586254972864],[-58.8311596069488,-27.4587768388404],[-58.8313490504731,-27.4589186949952],[-58.8314231092149,-27.4591161988817],[-58.8314272836051,-27.4593687522477],[-58.8313904163675,-27.4595857585206],[-58.8312455909167,-27.4596959239639],[-58.8310454508417,-27.4598248601225],[-58.830925232425,-27.4598941039011],[-58.8307863560145,-27.4600583210157],[-58.8306479262839,-27.4602495973054],[-58.8306210197089,-27.4604574507312],[-58.8305335934639,-27.460675121527],[-58.830413895354,-27.460775934098],[-58.8303447543074,-27.460876081984],[-58.8304158325264,-27.4608931910575],[-58.8305373190332,-27.4609006156662],[-58.8306982081223,-27.4608443700378],[-58.8307160464253,-27.4606997879103],[-58.8307929137783,-27.4604551906745],[-58.8308198200283,-27.4602473372311],[-58.8309989930719,-27.4600735684636],[-58.8311699920912,-27.4600171893894],[-58.8312940735219,-27.4598757208062],[-58.8315243983168,-27.4597373655399],[-58.8317050605272,-27.4596537935596],[-58.8318546428578,-27.4595255216297],[-58.8321261571525,-27.4594317321305],[-58.8323074150082,-27.459384238446],[-58.8324171477352,-27.4592925772071],[-58.83261982127,-27.4593169750615],[-58.8327967690281,-27.4593146460788],[-58.8329973536628,-27.4592127668032],[-58.8331180922395,-27.459175090469],[-58.833260694868,-27.4592363650802],[-58.8333130421882,-27.4593439364903],[-58.8334547496269,-27.4593510923686],[-58.833528215358,-27.4595125159167],[-58.8335019113471,-27.4597564486547],[-58.8336040695678,-27.4598182554345],[-58.8338383471823,-27.4599189198705],[-58.833861107781,-27.4600719892764],[-58.8340438588212,-27.4601146908092],[-58.8342020781532,-27.4602028238284],[-58.8344976974077,-27.460343276743],[-58.8348484072557,-27.4604514270474],[-58.8350669225876,-27.4605162101802],[-58.8357320583571,-27.4606788550433],[-58.8363601614673,-27.4607427462844],[-58.836786335936,-27.4608273420171],[-58.8372875987663,-27.4608658370938],[-58.8373091677704,-27.4609467478244],[-58.8372509671468,-27.4610963739333],[-58.8374131988851,-27.4611212982715],[-58.8376157268426,-27.461136668897],[-58.8377975831122,-27.4611252469662],[-58.8378798212084,-27.4612053567959],[-58.8381442151638,-27.4612920836297],[-58.8383767784927,-27.4612890132082],[-58.8387404163517,-27.4612616572437],[-58.8388644889921,-27.4611201823407],[-58.8389764632787,-27.4611638119718],[-58.8390085941588,-27.4612716479898],[-58.839160714981,-27.4612967038089],[-58.8393932781866,-27.4612936316896],[-58.83958599464,-27.4613271724356],[-58.8398389305237,-27.4613328520997],[-58.8400448669109,-27.4612489354619],[-58.8403178756341,-27.4612453272941],[-58.8404589861931,-27.4612163970377],[-58.8407110226491,-27.4611679568446],[-58.8407898160069,-27.4610406114448],[-58.8407865940566,-27.4608466876062],[-58.8408244920112,-27.4606928177596],[-58.8409548908551,-27.4606279418664],[-58.8410467924758,-27.4606808569086],[-58.8411395934954,-27.4607878901566],[-58.8412532170721,-27.4609307347541],[-58.8412907805088,-27.4610610525635],[-58.8413736205826,-27.4611772390486],[-58.8414760840318,-27.4612570791773],[-58.8414363878855,-27.4613027126394],[-58.8413256118408,-27.4613312427248],[-58.8411602720595,-27.4614236461029],[-58.8412313519655,-27.4614407495522],[-58.8413969915276,-27.4613663855111],[-58.8416395160929,-27.4613541562003],[-58.8419126747823,-27.4613595646014],[-58.8421266645629,-27.4614559722033],[-58.8422495016695,-27.4615445638673],[-58.8423833503823,-27.4616871398415],[-58.8425240108164,-27.4616311483803],[-58.8428740562624,-27.4616986891958],[-58.8430890978192,-27.4618582331456],[-58.8434562625287,-27.4620428277522],[-58.8436592427718,-27.4620852485494],[-58.8437695685192,-27.4620296575113],[-58.8438409493679,-27.4620647989804],[-58.8440780926509,-27.4623368196672],[-58.8442284632488,-27.4625603700475],[-58.844463431129,-27.4627016044172],[-58.8445995367638,-27.4629794734029],[-58.8448541283463,-27.4630843603456],[-58.8450551580846,-27.463009523021],[-58.8452178445428,-27.4630614970954],[-58.8453594065302,-27.4630596208891],[-58.8455018700364,-27.463111862659],[-58.8454736388654,-27.4632385403609],[-58.8455570859914,-27.4633908027694],[-58.8457570423151,-27.4635550531039],[-58.8460433238139,-27.4637407127366],[-58.8462363466559,-27.4637922833176],[-58.8462788977126,-27.4639180225085],[-58.8464930463033,-27.4640234426126],[-58.8467978994885,-27.4641096158757],[-58.847209677585,-27.4642394781975],[-58.8474021000828,-27.4642549683857],[-58.8476681626469,-27.46444089278],[-58.8478207406003,-27.4644929978306],[-58.848177659248,-27.4646686936286],[-58.8484548140734,-27.4649131100145],[-58.8488471260957,-27.4650883340764],[-58.8489495983865,-27.4651681682159],[-58.8491216485523,-27.4651749048457],[-58.8493747432373,-27.4651895863821],[-58.8494062831567,-27.4652613407279],[-58.8494310243493,-27.465531661989],[-58.8495433080424,-27.4655933219923],[-58.8496555918571,-27.4656549818983],[-58.8496578510154,-27.4657902768293],[-58.8496998043405,-27.4658799360637],[-58.8498116366616,-27.4659145368394],[-58.8501301584871,-27.4659103042637],[-58.8502705184284,-27.4658362656155],[-58.850382501525,-27.4658798855842],[-58.8504827154362,-27.4658244236292],[-58.850694761683,-27.4658035616649],[-58.8508477948976,-27.4658827221916],[-58.8508501308883,-27.4660225268547],[-58.8509729797896,-27.4661111101691],[-58.85112480776,-27.4661181131237],[-58.8512579195443,-27.4662155813698],[-58.8514068023365,-27.4663489263756],[-58.8516211109404,-27.4664633577312],[-58.8519057505534,-27.4665497882256],[-58.8522619277214,-27.4666803746113],[-58.8523257664089,-27.4668689799631],[-58.8523088610079,-27.4670676812792],[-58.8523131598361,-27.4673247412073],[-58.8524299723004,-27.4676569880682],[-58.8526168150416,-27.4679431945962],[-58.8529302096571,-27.4682367381043],[-58.8531027172617,-27.4682705284853],[-58.8532936378904,-27.4681958137268],[-58.8533014860419,-27.4680603845026],[-58.8534026058477,-27.4680590382762],[-58.8536077134425,-27.4682277187395],[-58.8537500361575,-27.4682709318696],[-58.8537936543945,-27.4684598056415],[-58.8538857948169,-27.4685262409797],[-58.8540210256819,-27.4687499811922],[-58.8540980006495,-27.4691188434982],[-58.8545221824896,-27.4693838425603],[-58.8547487268844,-27.4696244087253],[-58.8549592024111,-27.4701132837704],[-58.8550693888405,-27.4706531139509],[-58.8551856091893,-27.4709492792561],[-58.855330278138,-27.4711322947578],[-58.8555032442221,-27.4711931407655],[-58.8556402954664,-27.47152511449],[-58.8557588538989,-27.4716588585398],[-58.855881712994,-27.4717474369485],[-58.8559034491796,-27.4718373635238],[-58.8558851896016,-27.4719548882611],[-58.8560066886229,-27.4719622899402],[-58.8560400490027,-27.4721422778627],[-58.8561180163636,-27.4725697659627],[-58.8563462432948,-27.4732117693813],[-58.8564383230527,-27.4735759175243],[-58.8573537798335,-27.4729772988623],[-58.8582501985329,-27.4721488770713],[-58.8589777237837,-27.4715031380989],[-58.8595357563144,-27.4710040058989],[-58.8605423912922,-27.4701154573728],[-58.8618823048115,-27.4688976664487],[-58.8625646629467,-27.4682750681175],[-58.859585489216,-27.4643273341978],[-58.8567881903817,-27.4615634481332],[-58.8536105049191,-27.4593278202204],[-58.8496209530294,-27.4557045411732],[-58.8464377170157,-27.4531169642952],[-58.8434525776378,-27.4508785326487],[-58.8416766850837,-27.4502028458003],[-58.8396862216428,-27.4484789404483],[-58.8371130467713,-27.4472859507976],[-58.8323429122164,-27.4444031889523],[-58.8274618903754,-27.4406060000084],[-58.8122837858207,-27.4328560729387],[-58.8049311477599,-27.4243537031185],[-58.8014762497173,-27.4158095985798],[-58.8013883096045,-27.4091435766072],[-58.7993805360657,-27.4034586557048],[-58.7986972232333,-27.4009007457639],[-58.7976969946824,-27.3984326242481],[-58.7961389124981,-27.3964678834726],[-58.7950478100672,-27.394312164116],[-58.7934688964264,-27.3923025472818],[-58.7915769956085,-27.389683440046],[-58.7901014103418,-27.3874920136061],[-58.7881748687722,-27.3855364096001],[-58.786317409586,-27.3837873961722],[-58.7840708396517,-27.38203431016],[-58.7819021469609,-27.3804064978253],[-58.7795646320871,-27.3789612419148],[-58.7769852602366,-27.3772393436371],[-58.7744496935303,-27.3757243430281],[-58.7721615031481,-27.3745083887989],[-58.7695316541374,-27.3730937330841],[-58.7675097770064,-27.3720953602141],[-58.7644281686394,-27.370862254299],[-58.7618832046888,-27.3700102506372],[-58.7592029627053,-27.3695478519528],[-58.7554633696291,-27.3698340273073],[-58.7517275159881,-27.3703591405191],[-58.7463939339835,-27.3711432436369],[-58.743185989138,-27.3711833530101],[-58.7386392842764,-27.3712400747421],[-58.7350377804609,-27.3716412725772],[-58.730882700771,-27.3712147003554],[-58.7263391967884,-27.371153693801],[-58.722721473655,-27.3708375157538],[-58.7190996859836,-27.3699303426109],[-58.7169387849967,-27.3684051347158],[-58.7151844032671,-27.3673530701665],[-58.7135650118994,-27.3665339012637],[-58.7120821095515,-27.3657175495028],[-58.710997201962,-27.3648241253242],[-58.7094613362812,-27.3641753036737],[-58.7087132899808,-27.3651453257996],[-58.7054979292763,-27.3693077925968],[-58.7045714701263,-27.3705100401957],[-58.7039078424119,-27.371388785552],[-58.7035263679914,-27.3718851520445]]]}"
187,558,625,1183,297,261,5.48,216,"{""type"":""Polygon"",""coordinates"":[[[-58.8379576494071,-27.4853959872987],[-58.8377505441889,-27.4854122551248],[-58.8374375449745,-27.4854479643008],[-58.836957969453,-27.485503915198],[-58.836458240828,-27.4855646412661],[-58.8352368038371,-27.4857205917427],[-58.8353017025572,-27.4862790800561],[-58.8353866053246,-27.4868237719016],[-58.8366136348844,-27.4866993217564],[-58.83666625706,-27.4871271568267],[-58.8366884306851,-27.4872441459363],[-58.8367187300468,-27.4875459721327],[-58.8367531135084,-27.4877891035051],[-58.8367971619346,-27.4880050422485],[-58.8371604386144,-27.4879506270983],[-58.8371806663929,-27.4879503600255],[-58.83810949597,-27.4878388548897],[-58.8381157147425,-27.4876042092855],[-58.8381220084241,-27.4873740735212],[-58.8381050034572,-27.4869593012429],[-58.8381029446426,-27.486530798996],[-58.838082980397,-27.4862423691778],[-58.8380691966265,-27.486021520255],[-58.8379576494071,-27.4853959872987]]]}"
211,484,498,982,290,359,14.16,69,"{""type"":""Polygon"",""coordinates"":[[[-58.8197214629921,-27.4914095609647],[-58.819460182279,-27.4918234662826],[-58.8189276490368,-27.4926604276746],[-58.8186066394813,-27.4931337535859],[-58.8179703365871,-27.4941209264446],[-58.8179160403529,-27.4942028314331],[-58.8175111965889,-27.4948080654448],[-58.8169929183633,-27.4955907035561],[-58.8166177425323,-27.4961549499673],[-58.8167504933982,-27.4962299010834],[-58.8179632653068,-27.4967688939064],[-58.818472860392,-27.4969967982734],[-58.8192921467733,-27.4972928247212],[-58.8197198634488,-27.4974631539401],[-58.8196656541166,-27.4972428310458],[-58.8209274100232,-27.4970684411989],[-58.8207965309348,-27.4964927647518],[-58.8207622526588,-27.4962541380309],[-58.8206864765786,-27.4959529024027],[-58.8206585920813,-27.4957953873625],[-58.8205657150673,-27.495377093154],[-58.8204352114194,-27.4948239654761],[-58.8203299956437,-27.4942705067213],[-58.8201988270525,-27.4936767896306],[-58.8200829801152,-27.4930918936007],[-58.8197214629921,-27.4914095609647]]]}"
212,365,381,746,182,199,23.06,32,"{""type"":""Polygon"",""coordinates"":[[[-58.8166177425323,-27.4961549499673],[-58.8158866470568,-27.4972245474698],[-58.8166103562324,-27.4975534134952],[-58.8171703047968,-27.4977671324551],[-58.8178122122925,-27.4980429301508],[-58.8180873164429,-27.4981611282054],[-58.8187751163564,-27.4984588757716],[-58.8194476731703,-27.4987523083032],[-58.8187913410717,-27.4997532796254],[-58.819372499245,-27.5000253529148],[-58.8202745128253,-27.5004285510442],[-58.8204987528149,-27.5005293661564],[-58.8218195816019,-27.5011751688972],[-58.82190109738,-27.5012101880652],[-58.8228338567264,-27.5007153069835],[-58.8236428470558,-27.5000776953753],[-58.823697810746,-27.5000363771537],[-58.8240332445015,-27.4998244800789],[-58.8238120560965,-27.498681624421],[-58.8236148943123,-27.4977685065195],[-58.8235057911109,-27.4972872756245],[-58.8234224962745,-27.4968372822687],[-58.8232460915681,-27.4959554672994],[-58.822885529294,-27.4961767131877],[-58.8226051404855,-27.4963517993069],[-58.8220692756864,-27.4966790893695],[-58.8215435967133,-27.4970107549478],[-58.8209824383512,-27.4973383722039],[-58.8209274100232,-27.4970684411989],[-58.8196656541166,-27.4972428310458],[-58.8197198634488,-27.4974631539401],[-58.8192921467733,-27.4972928247212],[-58.818472860392,-27.4969967982734],[-58.8179632653068,-27.4967688939064],[-58.8167504933982,-27.4962299010834],[-58.8166177425323,-27.4961549499673]]]}"
213,499,509,1008,268,302,52.77,19,"{""type"":""Polygon"",""coordinates"":[[[-58.8218195816019,-27.5011751688972],[-58.8204987528149,-27.5005293661564],[-58.8202745128253,-27.5004285510442],[-58.819372499245,-27.5000253529148],[-58.8187913410717,-27.4997532796254],[-58.8194476731703,-27.4987523083032],[-58.8187751163564,-27.4984588757716],[-58.8180873164429,-27.4981611282054],[-58.8178122122925,-27.4980429301508],[-58.8171703047968,-27.4977671324551],[-58.8166103562324,-27.4975534134952],[-58.8158866470568,-27.4972245474698],[-58.8152098380016,-27.4982122375954],[-58.8146901967123,-27.4989136901629],[-58.8142601053219,-27.4995237557896],[-58.8139981945242,-27.4999015731125],[-58.813509696905,-27.500652235028],[-58.8132630277827,-27.5010343632479],[-58.8130818843869,-27.5014021044123],[-58.8128773735919,-27.501887432378],[-58.8127075256553,-27.5023271997168],[-58.8123478168755,-27.5032205271926],[-58.8121135446748,-27.5037423288444],[-58.8132242203094,-27.5039127997991],[-58.8143194296563,-27.5040654200507],[-58.8152725803596,-27.5041928204765],[-58.8161651139111,-27.5043255166567],[-58.8168094487546,-27.5044388949554],[-58.8170144265331,-27.5045986082014],[-58.8176265639098,-27.5045996318433],[-58.819568965379,-27.5045877675129],[-58.8223154722914,-27.5045608323368],[-58.8222669890993,-27.5037675580991],[-58.822198355485,-27.5026723207689],[-58.8220152506047,-27.5019980917944],[-58.8218195816019,-27.5011751688972]]]}"
214,419,474,893,213,214,13.94,64,"{""type"":""Polygon"",""coordinates"":[[[-58.8223154722914,-27.5045608323368],[-58.819568965379,-27.5045877675129],[-58.819578377579,-27.505467260618],[-58.8195622043446,-27.5063290449337],[-58.8192180489829,-27.5063200143594],[-58.8192476166813,-27.5071947328905],[-58.8192575971476,-27.5087237809122],[-58.819364110816,-27.5087404309624],[-58.8200891042741,-27.5088346943712],[-58.8206515017305,-27.5088859741286],[-58.8211430882839,-27.5089381788551],[-58.8221717097073,-27.5090374767297],[-58.8221839888964,-27.5085546552671],[-58.8222476647333,-27.5081207796843],[-58.8223131239779,-27.5077951410251],[-58.822360213236,-27.5072757766125],[-58.8223849935058,-27.5063236631146],[-58.8223706493518,-27.5054532574074],[-58.8223154722914,-27.5045608323368]]]}"
215,560,534,1094,242,234,15.32,71,"{""type"":""Polygon"",""coordinates"":[[[-58.819568965379,-27.5045877675129],[-58.8176265639098,-27.5045996318433],[-58.8170144265331,-27.5045986082014],[-58.8173779386819,-27.5054779866559],[-58.8177094048772,-27.5062540330202],[-58.8172681131138,-27.5061831150839],[-58.8165377845267,-27.5060708624744],[-58.8154774396451,-27.5058862294757],[-58.8152046396677,-27.5065258210482],[-58.8149460228187,-27.5064885983428],[-58.8148335903636,-27.5070358793217],[-58.8147178013989,-27.5076869537395],[-58.8146354925152,-27.50822030892],[-58.8160341483938,-27.5083644435311],[-58.8168759148257,-27.5084842641849],[-58.8177629077024,-27.5085854451448],[-58.818720787271,-27.5086902042533],[-58.8192575971476,-27.5087237809122],[-58.8192476166813,-27.5071947328905],[-58.8192180489829,-27.5063200143594],[-58.8195622043446,-27.5063290449337],[-58.819578377579,-27.505467260618],[-58.819568965379,-27.5045877675129]]]}"
216,513,545,1058,292,274,21.14,50,"{""type"":""Polygon"",""coordinates"":[[[-58.8170144265331,-27.5045986082014],[-58.8168094487546,-27.5044388949554],[-58.8161651139111,-27.5043255166567],[-58.8152725803596,-27.5041928204765],[-58.8143194296563,-27.5040654200507],[-58.8132242203094,-27.5039127997991],[-58.8121135446748,-27.5037423288444],[-58.8117520538566,-27.5045274174258],[-58.8113751631373,-27.5052991731331],[-58.8111120865421,-27.5059160765495],[-58.810956735093,-27.506315055437],[-58.8108391130134,-27.5065466409708],[-58.8107380672611,-27.5068637170262],[-58.810682394366,-27.5071711805914],[-58.8105697924078,-27.5077094393183],[-58.8119691040978,-27.507894204504],[-58.8133024446383,-27.5080662829927],[-58.8146354925152,-27.50822030892],[-58.8147178013989,-27.5076869537395],[-58.8148335903636,-27.5070358793217],[-58.8149460228187,-27.5064885983428],[-58.8152046396677,-27.5065258210482],[-58.8154774396451,-27.5058862294757],[-58.8165377845267,-27.5060708624744],[-58.8172681131138,-27.5061831150839],[-58.8177094048772,-27.5062540330202],[-58.8173779386819,-27.5054779866559],[-58.8170144265331,-27.5045986082014]]]}"
217,654,684,1338,345,351,33.16,40,"{""type"":""Polygon"",""coordinates"":[[[-58.8146354925152,-27.50822030892],[-58.8133024446383,-27.5080662829927],[-58.8119691040978,-27.507894204504],[-58.8105697924078,-27.5077094393183],[-58.8105558740194,-27.5077863051966],[-58.8104903798003,-27.5081119399936],[-58.8103590211681,-27.5087406599954],[-58.810331036226,-27.5088853719087],[-58.8103319223111,-27.5089394907371],[-58.8101582149235,-27.5097627289237],[-58.8099405708729,-27.5103745281522],[-58.8096437670519,-27.5110956178919],[-58.8093748725464,-27.5116674854553],[-58.8092365667511,-27.5118722737218],[-58.8090032629931,-27.5121459606149],[-58.8088097591379,-27.5123785317],[-58.8086550226787,-27.5125068484661],[-58.8079120528204,-27.5131705849069],[-58.809876950755,-27.5135961118756],[-58.8106314340008,-27.5136359096136],[-58.810661857031,-27.5136400243461],[-58.8107327456133,-27.5136436121645],[-58.8113108574899,-27.5137263003937],[-58.8113362223655,-27.5137304808613],[-58.8114376818845,-27.5137472026848],[-58.8120001765182,-27.513803026292],[-58.8126395059103,-27.5139164872207],[-58.8129541498135,-27.5139755374499],[-58.8130758425453,-27.5139919942701],[-58.8135121796967,-27.5140674999201],[-58.8135847502601,-27.5135568267502],[-58.8136834989665,-27.5130999423864],[-58.8137626803381,-27.5126839108754],[-58.8138649319693,-27.5121322527093],[-58.814021193753,-27.5114806511036],[-58.8141279833828,-27.5108973575503],[-58.8149026064731,-27.5109323591167],[-58.8157792797664,-27.5110201541936],[-58.815833701744,-27.510329282855],[-58.8158552883909,-27.5101034582563],[-58.8158632036634,-27.5096612911147],[-58.8159357616315,-27.5091506170748],[-58.816006223967,-27.5088204045703],[-58.8160341483938,-27.5083644435311],[-58.8146354925152,-27.50822030892]]]}"
218,710,727,1437,345,357,39.71,36,"{""type"":""Polygon"",""coordinates"":[[[-58.8192575971476,-27.5087237809122],[-58.818720787271,-27.5086902042533],[-58.8177629077024,-27.5085854451448],[-58.8168759148257,-27.5084842641849],[-58.8160341483938,-27.5083644435311],[-58.816006223967,-27.5088204045703],[-58.8159357616315,-27.5091506170748],[-58.8158632036634,-27.5096612911147],[-58.8158552883909,-27.5101034582563],[-58.815833701744,-27.510329282855],[-58.8157792797664,-27.5110201541936],[-58.8149026064731,-27.5109323591167],[-58.8141279833828,-27.5108973575503],[-58.814021193753,-27.5114806511036],[-58.8138649319693,-27.5121322527093],[-58.8137626803381,-27.5126839108754],[-58.8136834989665,-27.5130999423864],[-58.8135847502601,-27.5135568267502],[-58.8135121796967,-27.5140674999201],[-58.8141359670791,-27.5141586022621],[-58.8151351736246,-27.5143124646718],[-58.8154699784465,-27.5143667350929],[-58.816332245768,-27.514499822258],[-58.8168394016194,-27.5145743922581],[-58.8170828633204,-27.5146118087462],[-58.817240187118,-27.5146413288146],[-58.8179913254609,-27.5147848794621],[-58.8182806086685,-27.5148397381413],[-58.8190608371127,-27.5149062181128],[-58.8194067265486,-27.5150189749125],[-58.8197211535835,-27.5150644798621],[-58.8205072592569,-27.5151804940045],[-58.8205158902223,-27.5150901641019],[-58.8205213273571,-27.5148059096615],[-58.8204009857157,-27.5142571619501],[-58.820197181313,-27.513862875337],[-58.8199777584646,-27.5134417276824],[-58.8197891316387,-27.5130472416832],[-58.8196492955665,-27.5128505942422],[-58.8196924432573,-27.51270568251],[-58.8196465907333,-27.5114567775307],[-58.8196302288869,-27.511384818041],[-58.8197284951757,-27.5112076091364],[-58.8198985389261,-27.5110881019097],[-58.8201145501844,-27.5109950579631],[-58.8203356933593,-27.510906457366],[-58.820441466674,-27.5108780077179],[-58.8205522979681,-27.5108494917769],[-58.8207448004961,-27.5108650149728],[-58.8210438190035,-27.5108971865448],[-58.8213734087756,-27.5109424896181],[-58.8217533562464,-27.5109735996982],[-58.821894907058,-27.5109672345026],[-58.8221717097073,-27.5090374767297],[-58.8211430882839,-27.5089381788551],[-58.8206515017305,-27.5088859741286],[-58.8200891042741,-27.5088346943712],[-58.819364110816,-27.5087404309624],[-58.8192575971476,-27.5087237809122]]]}"
219,489,445,934,302,305,14.71,63,"{""type"":""Polygon"",""coordinates"":[[[-58.8162376597434,-27.4868675303002],[-58.8148127812003,-27.4869582949807],[-58.814403684745,-27.4869952059754],[-58.8134592143168,-27.4870796918884],[-58.8124137502038,-27.4871745086565],[-58.8120852680578,-27.487192319363],[-58.8110534960099,-27.4871967301653],[-58.8111843490384,-27.4874656795194],[-58.8113254267769,-27.4880502568271],[-58.8114369759343,-27.4886848379248],[-58.8115947047754,-27.4893594154529],[-58.8117210593827,-27.4899712489835],[-58.8118365628726,-27.4905381148835],[-58.8119042639771,-27.4909657660987],[-58.8119920466896,-27.491384133969],[-58.812058419682,-27.4917306066403],[-58.8132900080804,-27.4915702133222],[-58.8131146871891,-27.4904402697454],[-58.8130435918476,-27.490423152693],[-58.8128570613342,-27.4898436808194],[-58.81284210404,-27.489239418952],[-58.8138318114416,-27.4891363034153],[-58.8151090290845,-27.4889843219509],[-58.8165685181714,-27.4888434819634],[-58.8164834831282,-27.4882852446499],[-58.8163668488188,-27.487650734958],[-58.8162376597434,-27.4868675303002]]]}"
220,675,718,1393,339,290,12.56,111,"{""type"":""Polygon"",""coordinates"":[[[-58.8165685181714,-27.4888434819634],[-58.8151090290845,-27.4889843219509],[-58.8138318114416,-27.4891363034153],[-58.81284210404,-27.489239418952],[-58.8128570613342,-27.4898436808194],[-58.8130435918476,-27.490423152693],[-58.8131146871891,-27.4904402697454],[-58.8132900080804,-27.4915702133222],[-58.8138200505529,-27.4915046631477],[-58.8143904756731,-27.4914340734991],[-58.8149054190715,-27.4913732269957],[-58.8154811216992,-27.4913160966755],[-58.8170057911475,-27.4911383136439],[-58.8171906748907,-27.4922320389589],[-58.8173367410012,-27.4921940442157],[-58.8182238220784,-27.4910772930988],[-58.8185458655409,-27.4906671066594],[-58.8181314221149,-27.4903793167992],[-58.8179318239003,-27.490237577199],[-58.817895905546,-27.4902064704457],[-58.8176243974148,-27.4899980069261],[-58.8175885533005,-27.4899714099809],[-58.8175269052295,-27.4899135740459],[-58.8171927879818,-27.4895886449587],[-58.817151294569,-27.4895260347511],[-58.8168678982915,-27.4892094641075],[-58.8165685181714,-27.4888434819634]]]}"
221,889,876,1765,404,356,14.98,118,"{""type"":""Polygon"",""coordinates"":[[[-58.8110534960099,-27.4871967301653],[-58.8099476803167,-27.4870036178544],[-58.8087097970426,-27.4867761262808],[-58.8087830559205,-27.487235283639],[-58.8089090971264,-27.4878290810907],[-58.8090301565492,-27.4884274539806],[-58.8091567169252,-27.4890528204095],[-58.8092945729494,-27.4897502137611],[-58.8094052279278,-27.4903306778195],[-58.8095210151558,-27.4909155858338],[-58.809646623128,-27.4914823224327],[-58.8099009088457,-27.4924939615057],[-58.8099987263399,-27.4929076893635],[-58.8110942293564,-27.4927761505137],[-58.8122716052138,-27.4927021780034],[-58.812058419682,-27.4917306066403],[-58.8119920466896,-27.491384133969],[-58.8119042639771,-27.4909657660987],[-58.8118365628726,-27.4905381148835],[-58.8117210593827,-27.4899712489835],[-58.8115947047754,-27.4893594154529],[-58.8114369759343,-27.4886848379248],[-58.8113254267769,-27.4880502568271],[-58.8111843490384,-27.4874656795194],[-58.8110534960099,-27.4871967301653]]]}"
222,567,642,1209,330,336,8.28,146,"{""type"":""Polygon"",""coordinates"":[[[-58.8087097970426,-27.4867761262808],[-58.80828852093,-27.4866868730134],[-58.8074867944962,-27.4865303866822],[-58.8075366529048,-27.4867958809972],[-58.8075916422378,-27.4870658195051],[-58.8076411328999,-27.4873087641239],[-58.8076733901657,-27.487425627954],[-58.8076909184738,-27.4875697483978],[-58.8077841809917,-27.4880151138533],[-58.807823779561,-27.488271719503],[-58.807895046861,-27.4886091094815],[-58.8079519539273,-27.4889963056478],[-58.8080074614714,-27.489297813255],[-58.8080352522181,-27.4894508220004],[-58.8081390745325,-27.4899231150532],[-58.8081887891268,-27.4901795890225],[-58.8082600591108,-27.4905169786132],[-58.8083759880049,-27.4911109076862],[-58.8084095004019,-27.4913044398105],[-58.8084616488591,-27.4917097408763],[-58.8087665268086,-27.4930319751211],[-58.8099987263399,-27.4929076893635],[-58.8099009088457,-27.4924939615057],[-58.809646623128,-27.4914823224327],[-58.8095210151558,-27.4909155858338],[-58.8094052279278,-27.4903306778195],[-58.8092945729494,-27.4897502137611],[-58.8091567169252,-27.4890528204095],[-58.8090301565492,-27.4884274539806],[-58.8089090971264,-27.4878290810907],[-58.8087830559205,-27.487235283639],[-58.8087097970426,-27.4867761262808]]]}"
223,404,497,901,262,227,3.7,244,"{""type"":""Polygon"",""coordinates"":[[[-58.8074867944962,-27.4865303866822],[-58.8072990976641,-27.4864967375666],[-58.8066984233429,-27.4865722010454],[-58.8063349841005,-27.4866175172932],[-58.8057650915808,-27.4867196424959],[-58.8058417763155,-27.4870795179621],[-58.8059015243728,-27.4873313519817],[-58.805923886594,-27.4874618773489],[-58.8048796593695,-27.4876333067624],[-58.8049365552466,-27.4880205047464],[-58.8049875854058,-27.4883581590486],[-58.8059763389084,-27.4881964703742],[-58.8062539610267,-27.4881612906668],[-58.8063653631609,-27.4881688662744],[-58.8067738790082,-27.4880958991929],[-58.8076515195462,-27.4879446632475],[-58.8077841809917,-27.4880151138533],[-58.8076909184738,-27.4875697483978],[-58.8076733901657,-27.487425627954],[-58.8076411328999,-27.4873087641239],[-58.8075916422378,-27.4870658195051],[-58.8075366529048,-27.4867958809972],[-58.8074867944962,-27.4865303866822]]]}"
224,781,832,1613,426,391,8.96,180,"{""type"":""Polygon"",""coordinates"":[[[-58.8057650915808,-27.4867196424959],[-58.8051442602423,-27.4867998717958],[-58.8047254131628,-27.4868594353078],[-58.8046622462542,-27.4870181355],[-58.8032820807575,-27.4876810850095],[-58.8032569425895,-27.4876904325568],[-58.8017702676608,-27.4883367043029],[-58.8016543223433,-27.4883607600478],[-58.8010872046508,-27.4886342443538],[-58.8007357043121,-27.4887921639544],[-58.7998921285823,-27.4891729715306],[-58.7998552659802,-27.4893944819749],[-58.7998139329415,-27.4896521373529],[-58.7997595554821,-27.4900407772475],[-58.8008433254914,-27.49012148324],[-58.8013446436045,-27.4901555919124],[-58.8016754780742,-27.4899708729525],[-58.8025084244696,-27.4895586160882],[-58.8039691635246,-27.4888720744193],[-58.804672079886,-27.4885517085238],[-58.8048979559695,-27.4884450284712],[-58.8049875854058,-27.4883581590486],[-58.8049365552466,-27.4880205047464],[-58.8048796593695,-27.4876333067624],[-58.805923886594,-27.4874618773489],[-58.8059015243728,-27.4873313519817],[-58.8058417763155,-27.4870795179621],[-58.8057650915808,-27.4867196424959]]]}"
225,360,446,806,250,318,12.46,65,"{""type"":""Polygon"",""coordinates"":[[[-58.8047254131628,-27.4868594353078],[-58.8038725464456,-27.4869787552811],[-58.8029793685094,-27.4871076141798],[-58.802631022968,-27.4871482143945],[-58.8022474249479,-27.4871982921105],[-58.8013894216245,-27.4873131526658],[-58.8002637607314,-27.4874540255643],[-58.799415646723,-27.4875552134514],[-58.7982394827648,-27.4877012340973],[-58.797664151907,-27.4877808423359],[-58.7977767952228,-27.4884875973438],[-58.7978890006157,-27.4891672924464],[-58.7979562073907,-27.4895678934893],[-58.7979788540323,-27.4897164603049],[-58.798064091034,-27.4902927530439],[-58.7981267551896,-27.4907249888451],[-58.7981499154013,-27.4909051251978],[-58.7982295110217,-27.4914454034625],[-58.7984723305678,-27.4914467758636],[-58.7988156344963,-27.4914062507484],[-58.799588947402,-27.4913691854699],[-58.7996288877511,-27.4910258412921],[-58.7996748386282,-27.490741060916],[-58.7997104549339,-27.4904428815285],[-58.7997595554821,-27.4900407772475],[-58.7998139329415,-27.4896521373529],[-58.7998552659802,-27.4893944819749],[-58.7998921285823,-27.4891729715306],[-58.8007357043121,-27.4887921639544],[-58.8010872046508,-27.4886342443538],[-58.8016543223433,-27.4883607600478],[-58.8017702676608,-27.4883367043029],[-58.8032569425895,-27.4876904325568],[-58.8032820807575,-27.4876810850095],[-58.8046622462542,-27.4870181355],[-58.8047254131628,-27.4868594353078]]]}"
226,540,571,1111,293,254,12.3,90,"{""type"":""Polygon"",""coordinates"":[[[-58.797664151907,-27.4877808423359],[-58.7969879719362,-27.4878797942292],[-58.7964829985155,-27.487931423632],[-58.7959781708943,-27.4879920711269],[-58.7953472817661,-27.4880768978616],[-58.7938784522617,-27.488267255898],[-58.7939756084727,-27.4889561708393],[-58.7940625787445,-27.4896407060464],[-58.7941733006189,-27.4902302059825],[-58.7942331593837,-27.4908023180639],[-58.7956968910844,-27.4906075100823],[-58.7963028011255,-27.490541047357],[-58.7968680331943,-27.4904615746643],[-58.7969306928436,-27.4908938112138],[-58.7970387913643,-27.4916322015326],[-58.7982295110217,-27.4914454034625],[-58.7981499154013,-27.4909051251978],[-58.7981267551896,-27.4907249888451],[-58.798064091034,-27.4902927530439],[-58.7979788540323,-27.4897164603049],[-58.7979562073907,-27.4895678934893],[-58.7978890006157,-27.4891672924464],[-58.7977767952228,-27.4884875973438],[-58.797664151907,-27.4877808423359]]]}"
227,585,585,1170,272,255,11.56,101,"{""type"":""Polygon"",""coordinates"":[[[-58.799588947402,-27.4913691854699],[-58.7988156344963,-27.4914062507484],[-58.7984723305678,-27.4914467758636],[-58.7982295110217,-27.4914454034625],[-58.7970387913643,-27.4916322015326],[-58.7969306928436,-27.4908938112138],[-58.7968680331943,-27.4904615746643],[-58.7963028011255,-27.490541047357],[-58.7956968910844,-27.4906075100823],[-58.7942331593837,-27.4908023180639],[-58.7942557282845,-27.490946375734],[-58.7943131746975,-27.4913696592188],[-58.7943525245111,-27.491612740168],[-58.7944087284369,-27.4919593543402],[-58.7944591441007,-27.4922609341562],[-58.7944982020929,-27.4924859751945],[-58.7945659114592,-27.4929181478495],[-58.7945887008352,-27.4930757352379],[-58.7954370094267,-27.492983594523],[-58.7960575920252,-27.4928853668279],[-58.7966684981994,-27.4928143267105],[-58.7972138053538,-27.4927531531036],[-58.7973129681634,-27.4932525810932],[-58.7973908037333,-27.4936846211128],[-58.7983776395195,-27.4934012153094],[-58.7993743644108,-27.4931041421028],[-58.7994331412495,-27.4926748475165],[-58.7994921377702,-27.4922590827226],[-58.7995319318823,-27.491906718704],[-58.799588947402,-27.4913691854699]]]}"
229,505,566,1071,291,306,8.77,122,"{""type"":""Polygon"",""coordinates"":[[[-58.8077841809917,-27.4880151138533],[-58.8076515195462,-27.4879446632475],[-58.8067738790082,-27.4880958991929],[-58.8063653631609,-27.4881688662744],[-58.8062539610267,-27.4881612906668],[-58.8059763389084,-27.4881964703742],[-58.8049875854058,-27.4883581590486],[-58.8048979559695,-27.4884450284712],[-58.804672079886,-27.4885517085238],[-58.8039691635246,-27.4888720744193],[-58.8025084244696,-27.4895586160882],[-58.8027167336096,-27.4899258100153],[-58.8028103335894,-27.4900824782797],[-58.8029508442964,-27.4903242454271],[-58.8030810208587,-27.4905526136694],[-58.8032580354216,-27.490861570655],[-58.8052502073935,-27.489883941211],[-58.8059414138353,-27.4897757321785],[-58.8066324714648,-27.4896584999262],[-58.8072986838575,-27.4895686522779],[-58.8080352522181,-27.4894508220004],[-58.8080074614714,-27.489297813255],[-58.8079519539273,-27.4889963056478],[-58.807895046861,-27.4886091094815],[-58.807823779561,-27.488271719503],[-58.8077841809917,-27.4880151138533]]]}"
230,345,430,775,213,217,4.92,158,"{""type"":""Polygon"",""coordinates"":[[[-58.8080352522181,-27.4894508220004],[-58.8072986838575,-27.4895686522779],[-58.8066324714648,-27.4896584999262],[-58.8059414138353,-27.4897757321785],[-58.8052502073935,-27.489883941211],[-58.8053267461313,-27.4902347969267],[-58.805408342574,-27.4905855869401],[-58.8054407660056,-27.4910227216899],[-58.8064499917678,-27.4908742958766],[-58.8068581492184,-27.4907787784809],[-58.8072720996358,-27.4907282934503],[-58.8073180077899,-27.4910615021363],[-58.8073290060766,-27.491115489812],[-58.8073042613168,-27.4914586379771],[-58.8073822812269,-27.4918996905363],[-58.8084616488591,-27.4917097408763],[-58.8084095004019,-27.4913044398105],[-58.8083759880049,-27.4911109076862],[-58.8082600591108,-27.4905169786132],[-58.8081887891268,-27.4901795890225],[-58.8081390745325,-27.4899231150532],[-58.8080352522181,-27.4894508220004]]]}"
231,627,670,1297,299,268,12.59,103,"{""type"":""Polygon"",""coordinates"":[[[-58.8052502073935,-27.489883941211],[-58.8032580354216,-27.490861570655],[-58.8037942160096,-27.4917928842623],[-58.8040852879776,-27.4922717747814],[-58.8044857276562,-27.4929432140423],[-58.8045897416526,-27.4931177893248],[-58.8046836414289,-27.4932924957091],[-58.8048449047624,-27.4935655675245],[-58.8050837208088,-27.4939413831752],[-58.8058505694863,-27.4935074090451],[-58.8061934342217,-27.4934398060136],[-58.8066875749839,-27.4933431725311],[-58.8071215431495,-27.493278895047],[-58.8076664022244,-27.4931906211083],[-58.8086396530512,-27.4930065592475],[-58.8087665268086,-27.4930319751211],[-58.8084616488591,-27.4917097408763],[-58.8073822812269,-27.4918996905363],[-58.8073042613168,-27.4914586379771],[-58.8073290060766,-27.491115489812],[-58.8073180077899,-27.4910615021363],[-58.8072720996358,-27.4907282934503],[-58.8068581492184,-27.4907787784809],[-58.8064499917678,-27.4908742958766],[-58.8054407660056,-27.4910227216899],[-58.805408342574,-27.4905855869401],[-58.8053267461313,-27.4902347969267],[-58.8052502073935,-27.489883941211]]]}"
232,393,441,834,219,224,6.23,134,"{""type"":""Polygon"",""coordinates"":[[[-58.8032580354216,-27.490861570655],[-58.8025803127371,-27.4911770926815],[-58.8022690441069,-27.4913209624302],[-58.801766849284,-27.4915439891501],[-58.8011187189447,-27.4915027610379],[-58.8004502133078,-27.4914527717736],[-58.8002121576479,-27.491433297639],[-58.799588947402,-27.4913691854699],[-58.7995319318823,-27.491906718704],[-58.7994921377702,-27.4922590827226],[-58.7994331412495,-27.4926748475165],[-58.7999952314246,-27.4927126855421],[-58.8005069693454,-27.4927647055648],[-58.8009629308624,-27.4928084239169],[-58.8015252421627,-27.4928597855051],[-58.8026140241715,-27.4929359008627],[-58.8026634947024,-27.4928675966394],[-58.8030171956938,-27.4925337189115],[-58.8033360084385,-27.4922318687279],[-58.8037942160096,-27.4917928842623],[-58.8032580354216,-27.490861570655]]]}"
233,501,529,1030,266,261,8.93,115,"{""type"":""Polygon"",""coordinates"":[[[-58.8037942160096,-27.4917928842623],[-58.8033360084385,-27.4922318687279],[-58.8030171956938,-27.4925337189115],[-58.8026634947024,-27.4928675966394],[-58.8026140241715,-27.4929359008627],[-58.8025046010199,-27.4930500906429],[-58.8016612207526,-27.4934444397962],[-58.800998576183,-27.4937552485738],[-58.800812850336,-27.4938433594983],[-58.8006210392953,-27.4938683965335],[-58.8007385395154,-27.4942503010693],[-58.8008452652359,-27.494591746956],[-58.8009572692833,-27.4949466570499],[-58.8010692741129,-27.4953015670019],[-58.8011823076888,-27.4957196158843],[-58.8025934430054,-27.4950878588681],[-58.8035672935409,-27.4946286601549],[-58.8041747458861,-27.4943456202608],[-58.8044207897366,-27.4942341682143],[-58.8047422514459,-27.4940946721664],[-58.8050837208088,-27.4939413831752],[-58.8048449047624,-27.4935655675245],[-58.8046836414289,-27.4932924957091],[-58.8045897416526,-27.4931177893248],[-58.8044857276562,-27.4929432140423],[-58.8040852879776,-27.4922717747814],[-58.8037942160096,-27.4917928842623]]]}"
234,398,442,840,216,216,5.26,160,"{""type"":""Polygon"",""coordinates"":[[[-58.8026140241715,-27.4929359008627],[-58.8015252421627,-27.4928597855051],[-58.8009629308624,-27.4928084239169],[-58.8005069693454,-27.4927647055648],[-58.7999952314246,-27.4927126855421],[-58.7994331412495,-27.4926748475165],[-58.7993743644108,-27.4931041421028],[-58.7993815522317,-27.4935461161982],[-58.7995988781427,-27.4941567860229],[-58.7997207723371,-27.494498036697],[-58.7997789709625,-27.4946551648729],[-58.7998425206033,-27.4948302673369],[-58.7999595057742,-27.4951806030006],[-58.8000819160464,-27.4955534227592],[-58.800141143194,-27.4957736898182],[-58.8002527794944,-27.4961060507941],[-58.8011823076888,-27.4957196158843],[-58.8010692741129,-27.4953015670019],[-58.8009572692833,-27.4949466570499],[-58.8008452652359,-27.494591746956],[-58.8007385395154,-27.4942503010693],[-58.8006210392953,-27.4938683965335],[-58.800812850336,-27.4938433594983],[-58.800998576183,-27.4937552485738],[-58.8016612207526,-27.4934444397962],[-58.8025046010199,-27.4930500906429],[-58.8026140241715,-27.4929359008627]]]}"
235,517,511,1028,225,224,8.93,115,"{""type"":""Polygon"",""coordinates"":[[[-58.7993743644108,-27.4931041421028],[-58.7983776395195,-27.4934012153094],[-58.7973908037333,-27.4936846211128],[-58.7973129681634,-27.4932525810932],[-58.7972138053538,-27.4927531531036],[-58.7966684981994,-27.4928143267105],[-58.7960575920252,-27.4928853668279],[-58.7954370094267,-27.492983594523],[-58.7945887008352,-27.4930757352379],[-58.7946676229955,-27.4935754265773],[-58.7947588554712,-27.4942102858433],[-58.7947878734368,-27.4944399671111],[-58.7948721478837,-27.4949576327077],[-58.7949931507028,-27.4952447687514],[-58.7950832974946,-27.4955007265428],[-58.7964768755147,-27.495031649136],[-58.7971517075057,-27.494847008767],[-58.7976097299811,-27.4947057647435],[-58.7976910874956,-27.4947317788478],[-58.7987532785494,-27.4944158201798],[-58.7995988781427,-27.4941567860229],[-58.7993815522317,-27.4935461161982],[-58.7993743644108,-27.4931041421028]]]}"
236,871,894,1765,398,392,16.91,104,"{""type"":""Polygon"",""coordinates"":[[[-58.7995988781427,-27.4941567860229],[-58.7987532785494,-27.4944158201798],[-58.7976910874956,-27.4947317788478],[-58.7976097299811,-27.4947057647435],[-58.7971517075057,-27.494847008767],[-58.7964768755147,-27.495031649136],[-58.7950832974946,-27.4955007265428],[-58.7939666224739,-27.4958895347393],[-58.793514451509,-27.4960803114758],[-58.7934974387837,-27.4962790101828],[-58.7935357655768,-27.4964589518714],[-58.7936101528437,-27.4966790266792],[-58.7937456688981,-27.4969253786281],[-58.7939159917327,-27.497446446105],[-58.7941681144476,-27.4980205890363],[-58.7950037116759,-27.4977662215188],[-58.7958091062319,-27.4975212607681],[-58.7963931393997,-27.4973513283142],[-58.7969268156173,-27.4971955765907],[-58.7970221751268,-27.4971492359276],[-58.7972556948418,-27.4978228525964],[-58.7976277517547,-27.4976827187278],[-58.798075376849,-27.4975235636343],[-58.798572842167,-27.4973186539112],[-58.7995497334789,-27.4967331380926],[-58.800266123507,-27.4963043570742],[-58.8002527794944,-27.4961060507941],[-58.800141143194,-27.4957736898182],[-58.8000819160464,-27.4955534227592],[-58.7999595057742,-27.4951806030006],[-58.7998425206033,-27.4948302673369],[-58.7997789709625,-27.4946551648729],[-58.7997207723371,-27.494498036697],[-58.7995988781427,-27.4941567860229]]]}"
237,837,939,1776,429,452,26.18,68,"{""type"":""Polygon"",""coordinates"":[[[-58.7938784522617,-27.488267255898],[-58.7932481440329,-27.4883881529224],[-58.7925270987491,-27.4885282596775],[-58.7916961094341,-27.488750974722],[-58.789615982348,-27.4893010088527],[-58.78914683493,-27.4893792165789],[-58.7887333882998,-27.4894612176047],[-58.788299493723,-27.4895299475067],[-58.787855411348,-27.48959429607],[-58.7879971431909,-27.490539765221],[-58.7880439409313,-27.4909316126625],[-58.7880910306015,-27.4913414999273],[-58.788178432989,-27.4917418472335],[-58.7882456798872,-27.4921469644013],[-58.7883225317036,-27.4925203817107],[-58.7883897068737,-27.4929209887508],[-58.7884784241412,-27.4934025150725],[-58.7890084957344,-27.4933370583562],[-58.7893770969754,-27.4932962309529],[-58.7900585950128,-27.4932107790498],[-58.7900066584656,-27.4928144878968],[-58.7910169499238,-27.4927293118023],[-58.7911078351738,-27.4927191200194],[-58.792012432746,-27.4926668736478],[-58.7920656352449,-27.4928285807574],[-58.7925656496885,-27.4927815413756],[-58.7931918764978,-27.4927193408867],[-58.7931468866922,-27.4924402450754],[-58.7939139834221,-27.4923311168305],[-58.7944591441007,-27.4922609341562],[-58.7944087284369,-27.4919593543402],[-58.7943525245111,-27.491612740168],[-58.7943131746975,-27.4913696592188],[-58.7942557282845,-27.490946375734],[-58.7942331593837,-27.4908023180639],[-58.7941733006189,-27.4902302059825],[-58.7940625787445,-27.4896407060464],[-58.7939756084727,-27.4889561708393],[-58.7938784522617,-27.488267255898]]]}"
238,528,647,1175,292,291,7.72,152,"{""type"":""Polygon"",""coordinates"":[[[-58.787855411348,-27.48959429607],[-58.7873913182605,-27.4896724330097],[-58.7871088454513,-27.4897211703964],[-58.7869625517735,-27.489745603827],[-58.7867306502417,-27.4897936909729],[-58.7865138471954,-27.4898370729728],[-58.786312215486,-27.4898802598695],[-58.786034871514,-27.4899334401714],[-58.7861749869274,-27.4907796924258],[-58.7862217055991,-27.4911670307965],[-58.7863041166693,-27.4915719545171],[-58.786438451512,-27.492373171325],[-58.7865055469718,-27.4927692696406],[-58.786567148735,-27.4931383729913],[-58.7866466176049,-27.4936741503737],[-58.7875454408279,-27.4935768978443],[-58.7884784241412,-27.4934025150725],[-58.7883897068737,-27.4929209887508],[-58.7883225317036,-27.4925203817107],[-58.7882456798872,-27.4921469644013],[-58.788178432989,-27.4917418472335],[-58.7880910306015,-27.4913414999273],[-58.7880439409313,-27.4909316126625],[-58.7879971431909,-27.490539765221],[-58.787855411348,-27.48959429607]]]}"
239,799,870,1669,424,407,29.48,57,"{""type"":""Polygon"",""coordinates"":[[[-58.781154009013,-27.490582425093],[-58.7810691251019,-27.490651175426],[-58.7808778941175,-27.490712265087],[-58.780674661496,-27.4906562242598],[-58.7797036535122,-27.4903528834019],[-58.7785397775754,-27.4931555132193],[-58.7780281072242,-27.4943664682979],[-58.7778817481081,-27.4947021466252],[-58.777258016987,-27.4961806753137],[-58.7790846200728,-27.4958956954214],[-58.7796652858843,-27.4958296267517],[-58.7809728456104,-27.4956685448571],[-58.7812906664479,-27.4956148558621],[-58.7820626401308,-27.4954921967342],[-58.782043327027,-27.4952353221487],[-58.7819033805687,-27.4943980849771],[-58.7819467179746,-27.4942622025366],[-58.7827494616591,-27.4941662112861],[-58.7830625831535,-27.4941351331793],[-58.7836884619493,-27.4940504249851],[-58.7842543057878,-27.4940070821265],[-58.7845724108324,-27.4939714258261],[-58.7854911773992,-27.4938558869977],[-58.7866466176049,-27.4936741503737],[-58.786567148735,-27.4931383729913],[-58.7865055469718,-27.4927692696406],[-58.786438451512,-27.492373171325],[-58.7863041166693,-27.4915719545171],[-58.7851124962886,-27.4917045317929],[-58.784638131937,-27.4917737698526],[-58.7842042250647,-27.4918424875094],[-58.7837649694815,-27.4918932287569],[-58.783295515117,-27.4919533775168],[-58.7828463619463,-27.4920177754855],[-58.7824324638737,-27.4920726985484],[-58.7814783065475,-27.4921886699277],[-58.7813660043625,-27.4918111909725],[-58.7812839013733,-27.4914243034308],[-58.7812218828092,-27.4910281368535],[-58.781154009013,-27.490582425093]]]}"
240,927,1023,1950,487,514,55.58,35,"{""type"":""Polygon"",""coordinates"":[[[-58.7820626401308,-27.4954921967342],[-58.7812906664479,-27.4956148558621],[-58.7809728456104,-27.4956685448571],[-58.7796652858843,-27.4958296267517],[-58.7790846200728,-27.4958956954214],[-58.777258016987,-27.4961806753137],[-58.7767845351121,-27.4972512999707],[-58.7763072181495,-27.4983986577601],[-58.7760306658324,-27.4991329574933],[-58.7758098061159,-27.4995552924444],[-58.775606144905,-27.500103713262],[-58.7753863676547,-27.5005936975648],[-58.7756713361908,-27.5006983222789],[-58.7778486433577,-27.5014554111001],[-58.7785812348306,-27.5017121898926],[-58.7795668619765,-27.5019747495681],[-58.7796198341501,-27.5021229319376],[-58.7794415496564,-27.5026755439442],[-58.7792567031681,-27.5034492743237],[-58.7792561438737,-27.5037289579541],[-58.7796296973562,-27.5036790699688],[-58.7801896638634,-27.5035816862358],[-58.7808006430956,-27.5035107126389],[-58.7815976705153,-27.5033696899024],[-58.7823796676169,-27.503237877074],[-58.7835708342953,-27.5030692375814],[-58.784595454033,-27.5029252793878],[-58.7856049701744,-27.5027860185165],[-58.7854841615028,-27.5021966410346],[-58.7853345714146,-27.5013911093938],[-58.7851397185597,-27.5002884386056],[-58.7850929623344,-27.5002123532394],[-58.7849193638886,-27.4991725617513],[-58.7847308148988,-27.498146494318],[-58.7843268649686,-27.4981922743013],[-58.7837467725701,-27.4982944426739],[-58.7835262029055,-27.4984190652236],[-58.7832948632193,-27.4985032273276],[-58.7830982719552,-27.4985463454905],[-58.7829015351422,-27.4985804434284],[-58.7827923762116,-27.4987126587554],[-58.7824994720833,-27.498743477634],[-58.7810400060493,-27.4988974981339],[-58.7815488548174,-27.497826407471],[-58.7816454297715,-27.4975409832731],[-58.7819239196602,-27.4963014267626],[-58.7821494720236,-27.4961722320658],[-58.7820626401308,-27.4954921967342]]]}"
254,660,669,1329,297,254,6.48,205,"{""type"":""Polygon"",""coordinates"":[[[-58.8176028836157,-27.4803720979761],[-58.8175675610839,-27.4803770701583],[-58.8163607961619,-27.4805010860443],[-58.8151389318363,-27.4806297993549],[-58.8152157152757,-27.4809941785914],[-58.8153222202649,-27.4816288224057],[-58.8153957975175,-27.4821060150702],[-58.8155728511536,-27.4830329448277],[-58.816824785648,-27.4828857907709],[-58.8176222741128,-27.4827851596404],[-58.8177585845515,-27.4827698466134],[-58.8179958079662,-27.4827396825891],[-58.8179069747129,-27.4822581801724],[-58.8178294407618,-27.4818487039451],[-58.8177556311618,-27.4813579833465],[-58.8177064181784,-27.4811330826823],[-58.8176568351681,-27.4808856324733],[-58.8176028836157,-27.4803720979761]]]}"
241,544,544,1088,261,232,20.53,53,"{""type"":""Polygon"",""coordinates"":[[[-58.7854911773992,-27.4938558869977],[-58.7845724108324,-27.4939714258261],[-58.7842543057878,-27.4940070821265],[-58.7836884619493,-27.4940504249851],[-58.7830625831535,-27.4941351331793],[-58.7827494616591,-27.4941662112861],[-58.7819467179746,-27.4942622025366],[-58.7819033805687,-27.4943980849771],[-58.782043327027,-27.4952353221487],[-58.7820626401308,-27.4954921967342],[-58.7821494720236,-27.4961722320658],[-58.7819239196602,-27.4963014267626],[-58.7816454297715,-27.4975409832731],[-58.7815488548174,-27.497826407471],[-58.7810400060493,-27.4988974981339],[-58.7824994720833,-27.498743477634],[-58.7827923762116,-27.4987126587554],[-58.7829015351422,-27.4985804434284],[-58.7830982719552,-27.4985463454905],[-58.7832948632193,-27.4985032273276],[-58.7835262029055,-27.4984190652236],[-58.7837467725701,-27.4982944426739],[-58.7843268649686,-27.4981922743013],[-58.7847308148988,-27.498146494318],[-58.7855884154847,-27.4980001620762],[-58.7867291628289,-27.4978456773741],[-58.7866410627687,-27.4970889769904],[-58.7864927115621,-27.4963601155885],[-58.7863755082647,-27.4956804739041],[-58.7857595195982,-27.4957515347642],[-58.7855821772212,-27.4947929878608],[-58.7854911773992,-27.4938558869977]]]}"
242,519,572,1091,260,233,18.82,58,"{""type"":""Polygon"",""coordinates"":[[[-58.7900585950128,-27.4932107790498],[-58.7893770969754,-27.4932962309529],[-58.7890084957344,-27.4933370583562],[-58.7884784241412,-27.4934025150725],[-58.7875454408279,-27.4935768978443],[-58.7866466176049,-27.4936741503737],[-58.7854911773992,-27.4938558869977],[-58.7855821772212,-27.4947929878608],[-58.7857595195982,-27.4957515347642],[-58.7863755082647,-27.4956804739041],[-58.7864927115621,-27.4963601155885],[-58.7866410627687,-27.4970889769904],[-58.7867291628289,-27.4978456773741],[-58.7873145983986,-27.4977614716855],[-58.7879205546089,-27.4976950434363],[-58.7886118315514,-27.497586917509],[-58.7891164894809,-27.4975127646622],[-58.7903075812705,-27.4973440707508],[-58.7903535367575,-27.4973705447261],[-58.7903326194788,-27.4967032008605],[-58.7903119216464,-27.4960493868001],[-58.7902501081431,-27.495355503661],[-58.79019559324,-27.4951126165405],[-58.7901781809088,-27.494661750543],[-58.7901554925509,-27.4941974196964],[-58.7900781449324,-27.4934811816114],[-58.7900585950128,-27.4932107790498]]]}"
243,802,837,1639,417,401,18.26,90,"{""type"":""Polygon"",""coordinates"":[[[-58.7944591441007,-27.4922609341562],[-58.7939139834221,-27.4923311168305],[-58.7931468866922,-27.4924402450754],[-58.7931918764978,-27.4927193408867],[-58.7925656496885,-27.4927815413756],[-58.7920656352449,-27.4928285807574],[-58.792012432746,-27.4926668736478],[-58.7911078351738,-27.4927191200194],[-58.7910169499238,-27.4927293118023],[-58.7900066584656,-27.4928144878968],[-58.7900585950128,-27.4932107790498],[-58.7900781449324,-27.4934811816114],[-58.7901554925509,-27.4941974196964],[-58.7901781809088,-27.494661750543],[-58.79019559324,-27.4951126165405],[-58.7902501081431,-27.495355503661],[-58.7903119216464,-27.4960493868001],[-58.7903326194788,-27.4967032008605],[-58.7910290907004,-27.4966040181417],[-58.7916595943256,-27.4964921488715],[-58.7922244226463,-27.4963856337692],[-58.7927987799574,-27.4962429064418],[-58.7928643075154,-27.4962285293001],[-58.793514451509,-27.4960803114758],[-58.7939666224739,-27.4958895347393],[-58.7950832974946,-27.4955007265428],[-58.7949931507028,-27.4952447687514],[-58.7948721478837,-27.4949576327077],[-58.7947878734368,-27.4944399671111],[-58.7947588554712,-27.4942102858433],[-58.7946676229955,-27.4935754265773],[-58.7945887008352,-27.4930757352379],[-58.7945659114592,-27.4929181478495],[-58.7944982020929,-27.4924859751945],[-58.7944591441007,-27.4922609341562]]]}"
244,836,920,1756,386,360,15.35,114,"{""type"":""Polygon"",""coordinates"":[[[-58.793514451509,-27.4960803114758],[-58.7928643075154,-27.4962285293001],[-58.7927987799574,-27.4962429064418],[-58.7922244226463,-27.4963856337692],[-58.7916595943256,-27.4964921488715],[-58.7910290907004,-27.4966040181417],[-58.7903326194788,-27.4967032008605],[-58.7903535367575,-27.4973705447261],[-58.7903950186925,-27.4974331634493],[-58.7904732693693,-27.4978922679982],[-58.790594463315,-27.4985041902398],[-58.7906782844736,-27.4989947991341],[-58.7908329664791,-27.4998002584786],[-58.7909666902204,-27.5005608783658],[-58.791789479756,-27.5004510428738],[-58.7923497087615,-27.5003716512245],[-58.7929350056818,-27.5002784015644],[-58.7934744903305,-27.5001676965599],[-58.7947515162573,-27.4996820935078],[-58.794649055915,-27.4992909678441],[-58.7941681144476,-27.4980205890363],[-58.7939159917327,-27.497446446105],[-58.7937456688981,-27.4969253786281],[-58.7936101528437,-27.4966790266792],[-58.7935357655768,-27.4964589518714],[-58.7934974387837,-27.4962790101828],[-58.793514451509,-27.4960803114758]]]}"
245,1150,1217,2367,517,529,37.27,64,"{""type"":""Polygon"",""coordinates"":[[[-58.7903535367575,-27.4973705447261],[-58.7903075812705,-27.4973440707508],[-58.7891164894809,-27.4975127646622],[-58.7886118315514,-27.497586917509],[-58.7879205546089,-27.4976950434363],[-58.7873145983986,-27.4977614716855],[-58.7867291628289,-27.4978456773741],[-58.7855884154847,-27.4980001620762],[-58.7847308148988,-27.498146494318],[-58.7849193638886,-27.4991725617513],[-58.7850929623344,-27.5002123532394],[-58.7851397185597,-27.5002884386056],[-58.7853345714146,-27.5013911093938],[-58.7854841615028,-27.5021966410346],[-58.7856049701744,-27.5027860185165],[-58.784595454033,-27.5029252793878],[-58.7846966100573,-27.5035509971094],[-58.7848429967842,-27.5041580906621],[-58.7856459539287,-27.5040710994581],[-58.7866203653839,-27.5039503251725],[-58.787580329851,-27.503874838782],[-58.7875903555526,-27.5032431840572],[-58.788687091622,-27.5031794651588],[-58.7895920684751,-27.5031452703039],[-58.7910015795962,-27.5030278889012],[-58.7909936735299,-27.5028520658076],[-58.7909804176305,-27.5026582680122],[-58.7912130739474,-27.5026552722046],[-58.7912712103682,-27.5024966422414],[-58.7912325732542,-27.5013603942775],[-58.7912053310008,-27.5009276991171],[-58.7909666902204,-27.5005608783658],[-58.7908329664791,-27.4998002584786],[-58.7906782844736,-27.4989947991341],[-58.790594463315,-27.4985041902398],[-58.7904732693693,-27.4978922679982],[-58.7903950186925,-27.4974331634493],[-58.7903535367575,-27.4973705447261]]]}"
246,497,494,991,261,299,9.63,103,"{""type"":""Polygon"",""coordinates"":[[[-58.784595454033,-27.5029252793878],[-58.7835708342953,-27.5030692375814],[-58.7823796676169,-27.503237877074],[-58.7815976705153,-27.5033696899024],[-58.7808006430956,-27.5035107126389],[-58.7809162258022,-27.5040911400046],[-58.7810122321214,-27.5047124160278],[-58.7812627916237,-27.5061346540912],[-58.7818026822418,-27.5060465424258],[-58.7828874457365,-27.5058657381172],[-58.7834529138704,-27.5057953358739],[-58.7840334821086,-27.5057202267669],[-58.7839655845032,-27.5052745182414],[-58.7839163531922,-27.5050450936029],[-58.783792640476,-27.5042753156803],[-58.7848429967842,-27.5041580906621],[-58.7846966100573,-27.5035509971094],[-58.784595454033,-27.5029252793878]]]}"
247,683,741,1424,331,365,29.03,49,"{""type"":""Polygon"",""coordinates"":[[[-58.7753863676547,-27.5005936975648],[-58.7751921666889,-27.5011013988356],[-58.7742815346458,-27.503305323513],[-58.7740913694801,-27.5037498190723],[-58.775154249523,-27.5040971317831],[-58.7750955915533,-27.5045399501829],[-58.7749563779439,-27.5053221152583],[-58.7757448441675,-27.5055917279219],[-58.7766913417272,-27.5059360029053],[-58.7779020908518,-27.506353579103],[-58.7782481347227,-27.5064799716842],[-58.7784160627143,-27.5065409773192],[-58.7789863059445,-27.50645248835],[-58.7793951292279,-27.5063931277466],[-58.7795212876467,-27.5063734700436],[-58.7801321376055,-27.5062934787012],[-58.7806973924639,-27.5062095575493],[-58.7812627916237,-27.5061346540912],[-58.7810122321214,-27.5047124160278],[-58.7809162258022,-27.5040911400046],[-58.7808006430956,-27.5035107126389],[-58.7801896638634,-27.5035816862358],[-58.7796296973562,-27.5036790699688],[-58.7792561438737,-27.5037289579541],[-58.7792567031681,-27.5034492743237],[-58.7794415496564,-27.5026755439442],[-58.7796198341501,-27.5021229319376],[-58.7795668619765,-27.5019747495681],[-58.7785812348306,-27.5017121898926],[-58.7778486433577,-27.5014554111001],[-58.7756713361908,-27.5006983222789],[-58.7753863676547,-27.5005936975648]]]}"
248,1006,1075,2081,448,471,33.24,63,"{""type"":""Polygon"",""coordinates"":[[[-58.7910015795962,-27.5030278889012],[-58.7895920684751,-27.5031452703039],[-58.788687091622,-27.5031794651588],[-58.7875903555526,-27.5032431840572],[-58.787580329851,-27.503874838782],[-58.7866203653839,-27.5039503251725],[-58.7856459539287,-27.5040710994581],[-58.7848429967842,-27.5041580906621],[-58.783792640476,-27.5042753156803],[-58.7839163531922,-27.5050450936029],[-58.7839655845032,-27.5052745182414],[-58.7840334821086,-27.5057202267669],[-58.7849370270709,-27.5055958618076],[-58.7856840663813,-27.5054915440255],[-58.7858228221469,-27.5062521046899],[-58.7859393816148,-27.5068911558083],[-58.7865599796564,-27.5067884566021],[-58.7868072360661,-27.5067491931396],[-58.787226170745,-27.5066896796989],[-58.7887857907817,-27.5064666396039],[-58.7899103500004,-27.5062446708504],[-58.790606735271,-27.5061364675846],[-58.7909147562538,-27.5061009254996],[-58.7912935145625,-27.5060599608365],[-58.7913641453849,-27.5066725324921],[-58.7920725476173,-27.5066814502299],[-58.7921187852472,-27.5070372148292],[-58.7922667531352,-27.5077390070237],[-58.7923733818254,-27.5083872010238],[-58.7942519578216,-27.5081780317905],[-58.7955857285407,-27.5080660898734],[-58.7955844149907,-27.5076736598159],[-58.7954479232147,-27.5076799327975],[-58.795432032771,-27.5067012757023],[-58.7947593294061,-27.5067099579998],[-58.7942077231929,-27.506699031368],[-58.794302377264,-27.5059850899828],[-58.7929316155181,-27.505998256045],[-58.7929254985784,-27.504996917225],[-58.7929226469697,-27.5048210292437],[-58.7929100581038,-27.5043565697483],[-58.7928909364483,-27.5041132281024],[-58.7928782618558,-27.5039555102792],[-58.7928875861951,-27.5035945187723],[-58.7923211873785,-27.5036063292302],[-58.7917346302154,-27.503622907946],[-58.7911732155961,-27.5036301386352],[-58.79103592488,-27.5035867975717],[-58.7910015795962,-27.5030278889012]]]}"
249,834,904,1738,421,446,36.77,47,"{""type"":""Polygon"",""coordinates"":[[[-58.7947515162573,-27.4996820935078],[-58.7934744903305,-27.5001676965599],[-58.7929350056818,-27.5002784015644],[-58.7923497087615,-27.5003716512245],[-58.791789479756,-27.5004510428738],[-58.7909666902204,-27.5005608783658],[-58.7912053310008,-27.5009276991171],[-58.7912325732542,-27.5013603942775],[-58.7912712103682,-27.5024966422414],[-58.7912130739474,-27.5026552722046],[-58.7909804176305,-27.5026582680122],[-58.7909936735299,-27.5028520658076],[-58.7910015795962,-27.5030278889012],[-58.79103592488,-27.5035867975717],[-58.7911732155961,-27.5036301386352],[-58.7917346302154,-27.503622907946],[-58.7923211873785,-27.5036063292302],[-58.7928875861951,-27.5035945187723],[-58.7928782618558,-27.5039555102792],[-58.7928909364483,-27.5041132281024],[-58.7929100581038,-27.5043565697483],[-58.7929226469697,-27.5048210292437],[-58.7929254985784,-27.504996917225],[-58.7929316155181,-27.505998256045],[-58.794302377264,-27.5059850899828],[-58.7942077231929,-27.506699031368],[-58.7947593294061,-27.5067099579998],[-58.795432032771,-27.5067012757023],[-58.7956747396229,-27.5066936315031],[-58.7960995314116,-27.5066836355932],[-58.7967973771275,-27.5066656002395],[-58.7978589519837,-27.5066157948451],[-58.7978195125575,-27.5060569551644],[-58.7978170929628,-27.5059081272957],[-58.7977836651966,-27.5054078513184],[-58.7977734741809,-27.5047809702017],[-58.7977530945902,-27.5041497098314],[-58.7977429049635,-27.5038340796206],[-58.7977228931532,-27.50353661988],[-58.7976827966937,-27.5029371904006],[-58.797607370172,-27.5023427283179],[-58.7975830346048,-27.5017791820874],[-58.7975517358427,-27.5014096938946],[-58.7973440048767,-27.5013898237272],[-58.7965466508059,-27.5015083854209],[-58.7962486872101,-27.5015392987435],[-58.796074895159,-27.5014287706479],[-58.7959200892413,-27.5012413120895],[-58.7956521116899,-27.500938031174],[-58.7950799525451,-27.5002823150067],[-58.7950175776802,-27.5001793694239],[-58.7947515162573,-27.4996820935078]]]}"
250,403,433,836,262,283,10.32,81,"{""type"":""Polygon"",""coordinates"":[[[-58.8301436983474,-27.4765584683701],[-58.8295585666031,-27.4766518673214],[-58.8287863448348,-27.4767477222169],[-58.827494050038,-27.4768955110381],[-58.8263331450862,-27.4770370530922],[-58.8250766093795,-27.477206904743],[-58.8251566190169,-27.4777652022633],[-58.8252033164099,-27.4781435021348],[-58.8253934562353,-27.4795529074696],[-58.8266003447892,-27.4794378339656],[-58.8276403631434,-27.4793249415043],[-58.8277983762387,-27.4790928127545],[-58.8279672464435,-27.4789056497987],[-58.8286438389626,-27.4782246443009],[-58.828919489267,-27.4780721641027],[-58.8288947187535,-27.4777973274623],[-58.8293696575032,-27.4777685314495],[-58.829505214242,-27.4777081085367],[-58.8296858321036,-27.4776200280013],[-58.8302580227853,-27.4773553861082],[-58.8301436983474,-27.4765584683701]]]}"
251,470,542,1012,306,278,13.58,75,"{""type"":""Polygon"",""coordinates"":[[[-58.8250766093795,-27.477206904743],[-58.824652607545,-27.477257572586],[-58.8236935080717,-27.4773693818861],[-58.8225123653472,-27.4775111575464],[-58.8213109929178,-27.4776531880011],[-58.820467888753,-27.477745413854],[-58.8203618500084,-27.4777558225235],[-58.8197865919046,-27.4778355191015],[-58.8198994355987,-27.4785467607139],[-58.8199687885273,-27.479073625297],[-58.8200242477621,-27.4793706172754],[-58.8200584428587,-27.479604735162],[-58.8201375400349,-27.4801089177747],[-58.8209501743516,-27.4800080702482],[-58.8216219636024,-27.4799541702391],[-58.8226976131984,-27.4798543806265],[-58.8227933176135,-27.4798305728787],[-58.823929272174,-27.4797074296669],[-58.8239544808986,-27.4797025884331],[-58.8253934562353,-27.4795529074696],[-58.8252033164099,-27.4781435021348],[-58.8251566190169,-27.4777652022633],[-58.8250766093795,-27.477206904743]]]}"
252,315,364,679,233,282,4.32,157,"{""type"":""Polygon"",""coordinates"":[[[-58.8198994355987,-27.4785467607139],[-58.81981362227,-27.478556904523],[-58.8186021946163,-27.4787035544188],[-58.8185569076835,-27.4787176787739],[-58.8173657763252,-27.4788685636801],[-58.8174395818755,-27.4793592848165],[-58.8174902000722,-27.479669873859],[-58.8176028836157,-27.4803720979761],[-58.8188649717909,-27.4802293049137],[-58.8201375400349,-27.4801089177747],[-58.8200584428587,-27.479604735162],[-58.8200242477621,-27.4793706172754],[-58.8199687885273,-27.479073625297],[-58.8198994355987,-27.4785467607139]]]}"
253,236,281,517,202,257,4.1,126,"{""type"":""Polygon"",""coordinates"":[[[-58.8173657763252,-27.4788685636801],[-58.8161340403749,-27.4790109466069],[-58.814861995618,-27.4791628661114],[-58.8149007927934,-27.4793698604054],[-58.8149815958292,-27.4796710352372],[-58.8150420988395,-27.4799679638672],[-58.8150993202389,-27.4803731962078],[-58.8151389318363,-27.4806297993549],[-58.8163607961619,-27.4805010860443],[-58.8175675610839,-27.4803770701583],[-58.8176028836157,-27.4803720979761],[-58.8174902000722,-27.479669873859],[-58.8174395818755,-27.4793592848165],[-58.8173657763252,-27.4788685636801]]]}"
255,499,516,1015,257,234,11.24,90,"{""type"":""Polygon"",""coordinates"":[[[-58.8188649717909,-27.4802293049137],[-58.8176028836157,-27.4803720979761],[-58.8176568351681,-27.4808856324733],[-58.8177064181784,-27.4811330826823],[-58.8177556311618,-27.4813579833465],[-58.8178294407618,-27.4818487039451],[-58.8179069747129,-27.4822581801724],[-58.8179958079662,-27.4827396825891],[-58.8177585845515,-27.4827698466134],[-58.8176222741128,-27.4827851596404],[-58.816824785648,-27.4828857907709],[-58.8155728511536,-27.4830329448277],[-58.8157431237913,-27.4841629517829],[-58.8159307423614,-27.4851168079804],[-58.8181272958895,-27.4848941592105],[-58.8188245493638,-27.4848489606858],[-58.8191881981152,-27.4848171420084],[-58.8192537889384,-27.4848072627981],[-58.8192260006365,-27.4843475178613],[-58.8191838575988,-27.4839375800572],[-58.8191410478903,-27.4834870531314],[-58.8191091674679,-27.4830860028144],[-58.8190762497672,-27.4826218138922],[-58.8190564845137,-27.4823423985351],[-58.8190379792859,-27.4821396514246],[-58.819000672669,-27.4817161175764],[-58.8189710168278,-27.481450364038],[-58.8189497701458,-27.4810807506225],[-58.8189146134091,-27.4807880037308],[-58.8188649717909,-27.4802293049137]]]}"
256,525,497,1022,226,205,6.15,166,"{""type"":""Polygon"",""coordinates"":[[[-58.8209501743516,-27.4800080702482],[-58.8201375400349,-27.4801089177747],[-58.8188649717909,-27.4802293049137],[-58.8189146134091,-27.4807880037308],[-58.8189497701458,-27.4810807506225],[-58.8189710168278,-27.481450364038],[-58.819000672669,-27.4817161175764],[-58.8190379792859,-27.4821396514246],[-58.8190564845137,-27.4823423985351],[-58.8190762497672,-27.4826218138922],[-58.8195911488067,-27.4825609520801],[-58.819878864401,-27.4825256138092],[-58.8205148274771,-27.4824451219223],[-58.8206915166606,-27.4824247669538],[-58.8211458069166,-27.4823692032381],[-58.8212164528051,-27.4823592570042],[-58.8216908951286,-27.4822989169365],[-58.821424701219,-27.4814904458024],[-58.8212432762681,-27.4809154295796],[-58.8211208150029,-27.4805426303653],[-58.8209501743516,-27.4800080702482]]]}"
257,766,836,1602,405,342,14.67,109,"{""type"":""Polygon"",""coordinates"":[[[-58.8276403631434,-27.4793249415043],[-58.8266003447892,-27.4794378339656],[-58.8253934562353,-27.4795529074696],[-58.8239544808986,-27.4797025884331],[-58.823929272174,-27.4797074296669],[-58.8227933176135,-27.4798305728787],[-58.8226976131984,-27.4798543806265],[-58.8216219636024,-27.4799541702391],[-58.8209501743516,-27.4800080702482],[-58.8211208150029,-27.4805426303653],[-58.8212432762681,-27.4809154295796],[-58.821424701219,-27.4814904458024],[-58.8216908951286,-27.4822989169365],[-58.8225036919421,-27.4822070794312],[-58.822922657268,-27.4821564834397],[-58.8230098841494,-27.4822320254659],[-58.8241841554878,-27.4825910393214],[-58.8247940863319,-27.4827724989476],[-58.8255231472145,-27.481896852584],[-58.8260876332228,-27.4811631988165],[-58.8262016301558,-27.4810218664089],[-58.8276403631434,-27.4793249415043]]]}"
258,468,521,989,332,323,20.08,49,"{""type"":""Polygon"",""coordinates"":[[[-58.8303819812923,-27.4790408148015],[-58.8303453042548,-27.4786578747261],[-58.830242866431,-27.4776623234246],[-58.830220180239,-27.4775137635986],[-58.8302580227853,-27.4773553861082],[-58.8296858321036,-27.4776200280013],[-58.829505214242,-27.4777081085367],[-58.8293696575032,-27.4777685314495],[-58.8288947187535,-27.4777973274623],[-58.828919489267,-27.4780721641027],[-58.8286438389626,-27.4782246443009],[-58.8279672464435,-27.4789056497987],[-58.8277983762387,-27.4790928127545],[-58.8276403631434,-27.4793249415043],[-58.8262016301558,-27.4810218664089],[-58.8260876332228,-27.4811631988165],[-58.8255231472145,-27.481896852584],[-58.8247940863319,-27.4827724989476],[-58.8250793459787,-27.4828950621672],[-58.8251554202839,-27.4829075970271],[-58.8256588648462,-27.4830724058652],[-58.8257859532006,-27.483111336252],[-58.8259047859585,-27.4829564080246],[-58.8262819586096,-27.4828251548035],[-58.8267851020967,-27.482665181909],[-58.8272132865118,-27.4825603217225],[-58.8275914985158,-27.4824922033542],[-58.8278742281166,-27.4824614249619],[-58.8282130283365,-27.4824569745258],[-58.8286888068871,-27.4824777884821],[-58.8292367955951,-27.4825833578387],[-58.8296788921726,-27.4827083606781],[-58.8301624128797,-27.4828914583526],[-58.8305193674233,-27.4830671974774],[-58.8308767706416,-27.4832699948308],[-58.8308627035665,-27.4830311049127],[-58.83080266298,-27.482459016964],[-58.8307432198894,-27.481923007863],[-58.8306837029498,-27.4813824888003],[-58.8306082710567,-27.4807970704905],[-58.8305326164307,-27.4801981224435],[-58.8304472224934,-27.4796218566315],[-58.8303819812923,-27.4790408148015]]]}"
259,125,192,317,127,168,8.94,35,"{""type"":""Polygon"",""coordinates"":[[[-58.8308767706416,-27.4832699948308],[-58.8305193674233,-27.4830671974774],[-58.8301624128797,-27.4828914583526],[-58.8296788921726,-27.4827083606781],[-58.8292367955951,-27.4825833578387],[-58.8286888068871,-27.4824777884821],[-58.8282130283365,-27.4824569745258],[-58.8278742281166,-27.4824614249619],[-58.8275914985158,-27.4824922033542],[-58.8272132865118,-27.4825603217225],[-58.8267851020967,-27.482665181909],[-58.8262819586096,-27.4828251548035],[-58.8259047859585,-27.4829564080246],[-58.8257859532006,-27.483111336252],[-58.8258673076452,-27.4831373340074],[-58.8285574536523,-27.484017715062],[-58.8294015018926,-27.4842862943797],[-58.8310692333495,-27.4848146834479],[-58.8313845470134,-27.4849187944037],[-58.832518191549,-27.4852647378763],[-58.8324319605043,-27.4846388658898],[-58.8324138035476,-27.4844586711492],[-58.8321216095009,-27.4842234435784],[-58.8317627083091,-27.4839304524185],[-58.8313673670123,-27.4835747879446],[-58.8311014311413,-27.4833978535073],[-58.8308767706416,-27.4832699948308]]]}"
260,451,514,965,296,305,11.96,81,"{""type"":""Polygon"",""coordinates"":[[[-58.8346821014073,-27.4821598297056],[-58.8333521920675,-27.4821773562241],[-58.8321607531087,-27.4823103291199],[-58.83080266298,-27.482459016964],[-58.8308627035665,-27.4830311049127],[-58.8308767706416,-27.4832699948308],[-58.8311014311413,-27.4833978535073],[-58.8313673670123,-27.4835747879446],[-58.8317627083091,-27.4839304524185],[-58.8321216095009,-27.4842234435784],[-58.8324138035476,-27.4844586711492],[-58.8324319605043,-27.4846388658898],[-58.832518191549,-27.4852647378763],[-58.8339056564969,-27.4856659679157],[-58.8344484585463,-27.4857625626096],[-58.8351805802673,-27.4856852465151],[-58.8352368038371,-27.4857205917427],[-58.8351704851719,-27.4850764160737],[-58.8350947268782,-27.4844729623522],[-58.8350825944601,-27.4843513296104],[-58.8350023039878,-27.4837795114101],[-58.834924107846,-27.4833339690778],[-58.8348157483415,-27.483204583375],[-58.8346821014073,-27.4821598297056]]]}"
261,775,861,1636,514,462,13.47,121,"{""type"":""Polygon"",""coordinates"":[[[-58.8371409070535,-27.4806794124099],[-58.8357976424148,-27.480805398214],[-58.8345762562646,-27.4809613404648],[-58.8346459798238,-27.4815062335095],[-58.8347161527279,-27.4820781855958],[-58.8346821014073,-27.4821598297056],[-58.8348157483415,-27.483204583375],[-58.834924107846,-27.4833339690778],[-58.8350023039878,-27.4837795114101],[-58.8350825944601,-27.4843513296104],[-58.8350947268782,-27.4844729623522],[-58.8351704851719,-27.4850764160737],[-58.8352368038371,-27.4857205917427],[-58.836458240828,-27.4855646412661],[-58.836957969453,-27.485503915198],[-58.8374375449745,-27.4854479643008],[-58.8377505441889,-27.4854122551248],[-58.8376085893967,-27.4841736493181],[-58.8374476095827,-27.4830074676862],[-58.8373670837988,-27.4824221217427],[-58.8372714639122,-27.4818414857919],[-58.8371409070535,-27.4806794124099]]]}"
262,407,407,814,196,196,8.03,101,"{""type"":""Polygon"",""coordinates"":[[[-58.8247940863319,-27.4827724989476],[-58.8241841554878,-27.4825910393214],[-58.8230098841494,-27.4822320254659],[-58.822922657268,-27.4821564834397],[-58.8225036919421,-27.4822070794312],[-58.8216908951286,-27.4822989169365],[-58.8218542506684,-27.4830049838661],[-58.821941617078,-27.4833962850543],[-58.8220575177991,-27.4845991675312],[-58.8226789884234,-27.4845594528919],[-58.8232449076221,-27.4845249741956],[-58.8233972068106,-27.4845590655558],[-58.8237037374735,-27.4847445047596],[-58.8242453369006,-27.4850757201414],[-58.8244832334729,-27.4847793955456],[-58.82503755221,-27.4840413679915],[-58.8257710804859,-27.4831295748041],[-58.8257859532006,-27.483111336252],[-58.8256588648462,-27.4830724058652],[-58.8251554202839,-27.4829075970271],[-58.8250793459787,-27.4828950621672],[-58.8247940863319,-27.4827724989476]]]}"
263,417,527,944,232,225,6.83,138,"{""type"":""Polygon"",""coordinates"":[[[-58.8216908951286,-27.4822989169365],[-58.8212164528051,-27.4823592570042],[-58.8211458069166,-27.4823692032381],[-58.8206915166606,-27.4824247669538],[-58.8205148274771,-27.4824451219223],[-58.819878864401,-27.4825256138092],[-58.8195911488067,-27.4825609520801],[-58.8190762497672,-27.4826218138922],[-58.8191091674679,-27.4830860028144],[-58.8191410478903,-27.4834870531314],[-58.8191838575988,-27.4839375800572],[-58.8192260006365,-27.4843475178613],[-58.8192537889384,-27.4848072627981],[-58.8200920394951,-27.4847241276589],[-58.8202186831308,-27.4847360037667],[-58.8206582577219,-27.4847076989775],[-58.8209158599227,-27.4846862849555],[-58.8211736104066,-27.484673890243],[-58.8214361949929,-27.4846478991957],[-58.8216485079617,-27.4846406091956],[-58.8220575177991,-27.4845991675312],[-58.821941617078,-27.4833962850543],[-58.8218542506684,-27.4830049838661],[-58.8216908951286,-27.4822989169365]]]}"
264,552,565,1117,297,294,12.7,88,"{""type"":""Polygon"",""coordinates"":[[[-58.8202186831308,-27.4847360037667],[-58.8200920394951,-27.4847241276589],[-58.8192537889384,-27.4848072627981],[-58.8191881981152,-27.4848171420084],[-58.8188245493638,-27.4848489606858],[-58.8181272958895,-27.4848941592105],[-58.8159307423614,-27.4851168079804],[-58.8159594305149,-27.4853239335941],[-58.8159822479372,-27.4854815162468],[-58.8159942856588,-27.4855986417474],[-58.8159997865445,-27.4856256351734],[-58.8160899472301,-27.4861883171067],[-58.8161521599802,-27.4865889724269],[-58.8162376597434,-27.4868675303002],[-58.8163668488188,-27.487650734958],[-58.8175231954896,-27.4875318858035],[-58.8175787482117,-27.4875266493062],[-58.818735536369,-27.4874348495713],[-58.819897156503,-27.4873294444908],[-58.8200657763082,-27.4883557155281],[-58.820269762915,-27.4884567969624],[-58.8206416936692,-27.4880053556962],[-58.8205434834475,-27.4872623485809],[-58.8205078002539,-27.4869380334013],[-58.8204307101244,-27.4862488800718],[-58.8203578492347,-27.4858167904495],[-58.8202768169417,-27.4851953513891],[-58.8202186831308,-27.4847360037667]]]}"
265,337,427,764,234,254,6.63,115,"{""type"":""Polygon"",""coordinates"":[[[-58.8220575177991,-27.4845991675312],[-58.8216485079617,-27.4846406091956],[-58.8214361949929,-27.4846478991957],[-58.8211736104066,-27.484673890243],[-58.8209158599227,-27.4846862849555],[-58.8206582577219,-27.4847076989775],[-58.8202186831308,-27.4847360037667],[-58.8202768169417,-27.4851953513891],[-58.8203578492347,-27.4858167904495],[-58.8204307101244,-27.4862488800718],[-58.8208599541907,-27.4862071770011],[-58.8211881339004,-27.4861713062195],[-58.8213144823935,-27.4861651416825],[-58.8215872584882,-27.4861435276974],[-58.8221933445877,-27.4860904837365],[-58.8221189760348,-27.4861816747666],[-58.8221041765584,-27.486204422856],[-58.8219258399597,-27.4864323009452],[-58.8224572549299,-27.486759145607],[-58.8227383572142,-27.4869358980464],[-58.8231151068015,-27.4864708549141],[-58.8234967615633,-27.4859967248504],[-58.8238483691555,-27.4855410310784],[-58.8242453369006,-27.4850757201414],[-58.8237037374735,-27.4847445047596],[-58.8233972068106,-27.4845590655558],[-58.8232449076221,-27.4845249741956],[-58.8226789884234,-27.4845594528919],[-58.8220575177991,-27.4845991675312]]]}"
266,340,355,695,181,222,3.64,191,"{""type"":""Polygon"",""coordinates"":[[[-58.8227383572142,-27.4869358980464],[-58.8224572549299,-27.486759145607],[-58.8219258399597,-27.4864323009452],[-58.8221041765584,-27.486204422856],[-58.8221189760348,-27.4861816747666],[-58.8221933445877,-27.4860904837365],[-58.8215872584882,-27.4861435276974],[-58.8213144823935,-27.4861651416825],[-58.8211881339004,-27.4861713062195],[-58.8208599541907,-27.4862071770011],[-58.8204307101244,-27.4862488800718],[-58.8205078002539,-27.4869380334013],[-58.8205434834475,-27.4872623485809],[-58.8206416936692,-27.4880053556962],[-58.8208154235759,-27.4878046045634],[-58.8211783286597,-27.4880344199871],[-58.8216639395664,-27.4883438234771],[-58.821733252852,-27.4882526988364],[-58.8220303615609,-27.4878653856684],[-58.8224068943745,-27.4873868145564],[-58.8225056569909,-27.4872411735613],[-58.8227383572142,-27.4869358980464]]]}"
267,550,568,1118,314,281,13.21,85,"{""type"":""Polygon"",""coordinates"":[[[-58.8216639395664,-27.4883438234771],[-58.8211783286597,-27.4880344199871],[-58.8208154235759,-27.4878046045634],[-58.8206416936692,-27.4880053556962],[-58.820269762915,-27.4884567969624],[-58.8200657763082,-27.4883557155281],[-58.819897156503,-27.4873294444908],[-58.818735536369,-27.4874348495713],[-58.8175787482117,-27.4875266493062],[-58.8175231954896,-27.4875318858035],[-58.8163668488188,-27.487650734958],[-58.8164834831282,-27.4882852446499],[-58.8165685181714,-27.4888434819634],[-58.8168678982915,-27.4892094641075],[-58.817151294569,-27.4895260347511],[-58.8171927879818,-27.4895886449587],[-58.8175269052295,-27.4899135740459],[-58.8175885533005,-27.4899714099809],[-58.8176243974148,-27.4899980069261],[-58.817895905546,-27.4902064704457],[-58.8179318239003,-27.490237577199],[-58.8181314221149,-27.4903793167992],[-58.8185458655409,-27.4906671066594],[-58.8192384534045,-27.4909512586631],[-58.8198190457864,-27.4911917633697],[-58.8201378193737,-27.4905831383705],[-58.8204365096601,-27.4899837971992],[-58.8207071547889,-27.4895246590952],[-58.8207811556066,-27.4894109192518],[-58.8214162851654,-27.4886628256796],[-58.8216639395664,-27.4883438234771]]]}"
268,665,698,1363,396,346,11.78,116,"{""type"":""Polygon"",""coordinates"":[[[-58.7980169287283,-27.4687042029616],[-58.7975599697723,-27.4685928205844],[-58.7971940958588,-27.4684847717321],[-58.7969351337339,-27.4684204510048],[-58.7965643510538,-27.4683214856264],[-58.7963410753069,-27.4682747468555],[-58.7960618163133,-27.4682061754554],[-58.7957267936779,-27.4681293009708],[-58.7957780024698,-27.4684804912515],[-58.7958755112769,-27.4691919568142],[-58.7961202821132,-27.4708758780279],[-58.7963548114236,-27.4722396561021],[-58.7971565739228,-27.4720939800967],[-58.7972574810038,-27.4720791445867],[-58.7974994529044,-27.4720309111864],[-58.7981046745337,-27.4719283657146],[-58.799194128871,-27.4717473853267],[-58.7992893194997,-27.4716920241375],[-58.7991802070071,-27.4712017461993],[-58.7990100555188,-27.4703784501946],[-58.7990915428102,-27.4701022320503],[-58.7993982893357,-27.4690607598824],[-58.7987943321833,-27.4689287271182],[-58.7981896441216,-27.4687515920751],[-58.7980169287283,-27.4687042029616]]]}"
269,799,832,1631,429,431,34.28,48,"{""type"":""Polygon"",""coordinates"":[[[-58.7955489508765,-27.4680774639465],[-58.7945740769985,-27.4678374231942],[-58.7935280559043,-27.4675757375015],[-58.7935141116375,-27.4679638555458],[-58.7935808470187,-27.4683374014157],[-58.7936478020291,-27.4687244771226],[-58.7937053755609,-27.4691567827456],[-58.7937399491603,-27.4694179700731],[-58.7937627305152,-27.4695755583906],[-58.7938195746756,-27.4699627641867],[-58.7938611044282,-27.4703411454534],[-58.7939128932047,-27.4707284162926],[-58.7939598452924,-27.4711292821393],[-58.7933595333042,-27.4712227244899],[-58.7927235339605,-27.4712985802407],[-58.7927849940307,-27.4716586615609],[-58.7929183933767,-27.4724012436034],[-58.793016198815,-27.4728194984064],[-58.7930652113826,-27.4730353907128],[-58.7931552422182,-27.4735980945743],[-58.7932696068545,-27.4741018430015],[-58.7934211209336,-27.4747133744061],[-58.7936673640639,-27.4758649936717],[-58.7944690839165,-27.4757148218344],[-58.7956691674406,-27.4754918432026],[-58.7969343942423,-27.4752319261759],[-58.7972320675422,-27.4751874848063],[-58.7979429065542,-27.4750474884874],[-58.798245415565,-27.4749894498131],[-58.7986582139509,-27.474871343652],[-58.7995151726303,-27.4746978748746],[-58.7998727873775,-27.4746075439964],[-58.7997185995123,-27.4738336630586],[-58.7995205186478,-27.4728483369422],[-58.7994287711664,-27.4724931618738],[-58.7992893194997,-27.4716920241375],[-58.799194128871,-27.4717473853267],[-58.7981046745337,-27.4719283657146],[-58.7974994529044,-27.4720309111864],[-58.7972574810038,-27.4720791445867],[-58.7971565739228,-27.4720939800967],[-58.7963548114236,-27.4722396561021],[-58.7961202821132,-27.4708758780279],[-58.7958755112769,-27.4691919568142],[-58.7957780024698,-27.4684804912515],[-58.7957267936779,-27.4681293009708],[-58.7955489508765,-27.4680774639465]]]}"
270,764,808,1572,477,548,20.58,76,"{""type"":""Polygon"",""coordinates"":[[[-58.7899382038846,-27.4666836685474],[-58.7893745717875,-27.4665420536807],[-58.7888009744742,-27.4664095863547],[-58.7882119188991,-27.466259271485],[-58.7880140033322,-27.4662167042441],[-58.7872677016547,-27.4660368282544],[-58.7869323994958,-27.4659418920161],[-58.7870733534916,-27.4668422671104],[-58.7871742599131,-27.46745445706],[-58.787197031415,-27.4676120469604],[-58.7872771325432,-27.4681884164545],[-58.787315800734,-27.4683909114236],[-58.7874344992632,-27.4691652656378],[-58.7875142392856,-27.4697190848382],[-58.7875488714165,-27.4699847843575],[-58.7887297786098,-27.4698297771393],[-58.7899109005653,-27.4696882899891],[-58.7910510585174,-27.4695157435511],[-58.7923423881159,-27.4693096652381],[-58.7924302944578,-27.4697415809807],[-58.7924918983975,-27.4701106825378],[-58.7931733974399,-27.4700342419834],[-58.7938195746756,-27.4699627641867],[-58.7937627305152,-27.4695755583906],[-58.7937399491603,-27.4694179700731],[-58.7937053755609,-27.4691567827456],[-58.7936478020291,-27.4687244771226],[-58.7935808470187,-27.4683374014157],[-58.7935141116375,-27.4679638555458],[-58.7935280559043,-27.4675757375015],[-58.7927817377523,-27.4673958919835],[-58.7919490299122,-27.4671900888811],[-58.7915223459786,-27.4670737856041],[-58.7908267408336,-27.4669022985775],[-58.7905170056307,-27.4668250859785],[-58.7899382038846,-27.4666836685474]]]}"
271,585,599,1184,300,275,11.29,105,"{""type"":""Polygon"",""coordinates"":[[[-58.7938195746756,-27.4699627641867],[-58.7931733974399,-27.4700342419834],[-58.7924918983975,-27.4701106825378],[-58.7924302944578,-27.4697415809807],[-58.7923423881159,-27.4693096652381],[-58.7910510585174,-27.4695157435511],[-58.7899109005653,-27.4696882899891],[-58.7887297786098,-27.4698297771393],[-58.7888488533315,-27.470626679352],[-58.78895276113,-27.4714237762365],[-58.7890810782518,-27.4721664282057],[-58.7903077314726,-27.4720243516776],[-58.791483014991,-27.4718333055209],[-58.7927849940307,-27.4716586615609],[-58.7927235339605,-27.4712985802407],[-58.7933595333042,-27.4712227244899],[-58.7939598452924,-27.4711292821393],[-58.7939128932047,-27.4707284162926],[-58.7938611044282,-27.4703411454534],[-58.7938195746756,-27.4699627641867]]]}"
272,537,526,1063,251,242,13.03,82,"{""type"":""Polygon"",""coordinates"":[[[-58.7927849940307,-27.4716586615609],[-58.791483014991,-27.4718333055209],[-58.7903077314726,-27.4720243516776],[-58.7890810782518,-27.4721664282057],[-58.7891948111449,-27.4729453547027],[-58.7904313667493,-27.4727896167821],[-58.790558966601,-27.4734871669553],[-58.7906645192706,-27.4740722277203],[-58.7907785815679,-27.4745579387879],[-58.7909351393133,-27.4751694084348],[-58.7910349100706,-27.4757094339557],[-58.791165167107,-27.4762580888365],[-58.7926483572561,-27.4760269814562],[-58.7936673640639,-27.4758649936717],[-58.7934211209336,-27.4747133744061],[-58.7932696068545,-27.4741018430015],[-58.7931552422182,-27.4735980945743],[-58.7930652113826,-27.4730353907128],[-58.793016198815,-27.4728194984064],[-58.7929183933767,-27.4724012436034],[-58.7927849940307,-27.4716586615609]]]}"
273,656,731,1387,368,343,14.29,97,"{""type"":""Polygon"",""coordinates"":[[[-58.7887297786098,-27.4698297771393],[-58.7875488714165,-27.4699847843575],[-58.7876217366734,-27.4704259187144],[-58.7876829612327,-27.4707724731969],[-58.7878119241447,-27.4715557166882],[-58.7879049849302,-27.4723078446325],[-58.7880442831105,-27.4731044876343],[-58.7873376965696,-27.4731947586848],[-58.787467316106,-27.4740185920545],[-58.7881838749464,-27.4739191702344],[-58.7882939623413,-27.4744725985275],[-58.78838295095,-27.4749721667651],[-58.7884624830758,-27.4755124546217],[-58.7884791823783,-27.4756069692492],[-58.7886629497565,-27.4766511398263],[-58.7893942564128,-27.4765244562475],[-58.789964480684,-27.4764449496329],[-58.7906052039083,-27.4763464901301],[-58.791165167107,-27.4762580888365],[-58.7910349100706,-27.4757094339557],[-58.7909351393133,-27.4751694084348],[-58.7907785815679,-27.4745579387879],[-58.7906645192706,-27.4740722277203],[-58.790558966601,-27.4734871669553],[-58.7904313667493,-27.4727896167821],[-58.7891948111449,-27.4729453547027],[-58.7890810782518,-27.4721664282057],[-58.78895276113,-27.4714237762365],[-58.7888488533315,-27.470626679352],[-58.7887297786098,-27.4698297771393]]]}"
274,532,573,1105,308,342,124.63,9,"{""type"":""Polygon"",""coordinates"":[[[-58.7746699672191,-27.4628553752572],[-58.7739286896806,-27.4626708510805],[-58.7732734379148,-27.4624897382221],[-58.7725421323408,-27.4622960575902],[-58.7717350620303,-27.4621078480665],[-58.7696581013197,-27.4615658816466],[-58.768805321008,-27.4613647028429],[-58.7675404961321,-27.4610108665653],[-58.7676070144142,-27.4610596426291],[-58.7683903584558,-27.461663185459],[-58.7692091747223,-27.4622707837583],[-58.7703044103381,-27.4630868771089],[-58.770718991908,-27.463397371477],[-58.7727054758438,-27.4649193472064],[-58.7742203479448,-27.4660413187405],[-58.7757816958864,-27.4672213219213],[-58.7783520411036,-27.4691913667782],[-58.7786182977659,-27.4693954681139],[-58.7798030353347,-27.4704223511815],[-58.7805465147808,-27.4713691604159],[-58.7810767685036,-27.4722645623812],[-58.781430926857,-27.4732163467745],[-58.7824417394692,-27.4763159439761],[-58.7825413719598,-27.4765357032279],[-58.7827861016586,-27.4772858926965],[-58.7831311967067,-27.4783009400454],[-58.7846465609928,-27.4778665130341],[-58.7849335529029,-27.4777861472113],[-58.7850037308587,-27.4774333955986],[-58.7851179241712,-27.477301114422],[-58.7852791641636,-27.4760089237367],[-58.7853724464498,-27.4748935303082],[-58.785438331315,-27.4742746892865],[-58.7858977422033,-27.4742236864978],[-58.7861450723174,-27.4741934474624],[-58.7867860053975,-27.4741085359285],[-58.787467316106,-27.4740185920545],[-58.7873376965696,-27.4731947586848],[-58.7880442831105,-27.4731044876343],[-58.7879049849302,-27.4723078446325],[-58.7878119241447,-27.4715557166882],[-58.7876829612327,-27.4707724731969],[-58.7876217366734,-27.4704259187144],[-58.7875488714165,-27.4699847843575],[-58.7875142392856,-27.4697190848382],[-58.7874344992632,-27.4691652656378],[-58.787315800734,-27.4683909114236],[-58.7872771325432,-27.4681884164545],[-58.787197031415,-27.4676120469604],[-58.7871742599131,-27.46745445706],[-58.7870733534916,-27.4668422671104],[-58.7869323994958,-27.4659418920161],[-58.7864195532982,-27.465813145812],[-58.7857746686761,-27.4656500039598],[-58.7851553568315,-27.4655045748504],[-58.7839570407483,-27.4652041698505],[-58.7828498845703,-27.4649116088319],[-58.7817073415193,-27.4646194916382],[-58.7805697875174,-27.4643227901002],[-58.7802344229391,-27.4642233271753],[-58.7783156442486,-27.4637742000238],[-58.7773760138618,-27.463520052982],[-58.7764316930444,-27.4632885139701],[-58.7755632878115,-27.4630605112507],[-58.7746699672191,-27.4628553752572]]]}"
275,409,531,940,283,356,10.4,90,"{""type"":""Polygon"",""coordinates"":[[[-58.787467316106,-27.4740185920545],[-58.7867860053975,-27.4741085359285],[-58.7861450723174,-27.4741934474624],[-58.7858977422033,-27.4742236864978],[-58.785438331315,-27.4742746892865],[-58.7853724464498,-27.4748935303082],[-58.7852791641636,-27.4760089237367],[-58.7851179241712,-27.477301114422],[-58.7850037308587,-27.4774333955986],[-58.7849335529029,-27.4777861472113],[-58.7850740477367,-27.4777166816077],[-58.7863042610942,-27.477164099141],[-58.7872314710296,-27.4769537158935],[-58.7879272400767,-27.4768184744029],[-58.7886629497565,-27.4766511398263],[-58.7884791823783,-27.4756069692492],[-58.7884624830758,-27.4755124546217],[-58.78838295095,-27.4749721667651],[-58.7882939623413,-27.4744725985275],[-58.7881838749464,-27.4739191702344],[-58.787467316106,-27.4740185920545]]]}"
276,555,592,1147,288,288,41.59,28,"{""type"":""Polygon"",""coordinates"":[[[-58.7849335529029,-27.4777861472113],[-58.7846465609928,-27.4778665130341],[-58.7831311967067,-27.4783009400454],[-58.7834613464485,-27.4793297104561],[-58.7835846258174,-27.4797611788709],[-58.7836680336355,-27.4802292454683],[-58.7836739195098,-27.480594554411],[-58.7832235467145,-27.4818363174123],[-58.782885041562,-27.4828014799848],[-58.7828125299765,-27.4830099111587],[-58.7828044500985,-27.4831363203696],[-58.7827972418715,-27.4833168494255],[-58.7828512974904,-27.483532680966],[-58.7829466076869,-27.4837976040146],[-58.7833139746913,-27.4839958880684],[-58.7837255470601,-27.484112408007],[-58.7853284440577,-27.4840828314657],[-58.7859605580833,-27.4840747204909],[-58.7867789038314,-27.484010084677],[-58.7871728327108,-27.4839734498356],[-58.7882495155261,-27.4839325529532],[-58.7896993132974,-27.4838191861601],[-58.7911582722147,-27.4836470446592],[-58.7924925744015,-27.4832735030241],[-58.7936657058533,-27.4829426243926],[-58.7935057583426,-27.4821237014868],[-58.7933308049423,-27.4810027410195],[-58.7920385395178,-27.4811592249896],[-58.7914885202235,-27.4812384807695],[-58.7908476970057,-27.4813324356217],[-58.7906204572121,-27.4810421505568],[-58.7900911994031,-27.4808414573527],[-58.7893899411981,-27.4806384627288],[-58.7892935714659,-27.4806216581153],[-58.787834637517,-27.4801667616925],[-58.7878136094438,-27.4801174117805],[-58.7867713027744,-27.479778945905],[-58.7857131045227,-27.4793955667166],[-58.784610202738,-27.4790623725106],[-58.7844461353153,-27.4789246377115],[-58.7846806407301,-27.4784118971406],[-58.7849335529029,-27.4777861472113]]]}"
277,641,672,1313,338,308,26.27,50,"{""type"":""Polygon"",""coordinates"":[[[-58.791165167107,-27.4762580888365],[-58.7906052039083,-27.4763464901301],[-58.789964480684,-27.4764449496329],[-58.7893942564128,-27.4765244562475],[-58.7886629497565,-27.4766511398263],[-58.7879272400767,-27.4768184744029],[-58.7872314710296,-27.4769537158935],[-58.7863042610942,-27.477164099141],[-58.7850740477367,-27.4777166816077],[-58.7849335529029,-27.4777861472113],[-58.7846806407301,-27.4784118971406],[-58.7844461353153,-27.4789246377115],[-58.784610202738,-27.4790623725106],[-58.7857131045227,-27.4793955667166],[-58.7867713027744,-27.479778945905],[-58.7878136094438,-27.4801174117805],[-58.787834637517,-27.4801667616925],[-58.7892935714659,-27.4806216581153],[-58.7893899411981,-27.4806384627288],[-58.7900911994031,-27.4808414573527],[-58.7906204572121,-27.4810421505568],[-58.7908476970057,-27.4813324356217],[-58.7914885202235,-27.4812384807695],[-58.7920385395178,-27.4811592249896],[-58.7918251931918,-27.4801650616562],[-58.7919914077944,-27.4801223234312],[-58.7918073095751,-27.4790601196506],[-58.7916231425065,-27.4779934053345],[-58.7914983021327,-27.4774672359806],[-58.7914339230219,-27.476926755532],[-58.791308063555,-27.4763374462409],[-58.791165167107,-27.4762580888365]]]}"
278,825,866,1691,446,372,24.58,69,"{""type"":""Polygon"",""coordinates"":[[[-58.7972320675422,-27.4751874848063],[-58.7969343942423,-27.4752319261759],[-58.7956691674406,-27.4754918432026],[-58.7944690839165,-27.4757148218344],[-58.7936673640639,-27.4758649936717],[-58.7926483572561,-27.4760269814562],[-58.791165167107,-27.4762580888365],[-58.791308063555,-27.4763374462409],[-58.7914339230219,-27.476926755532],[-58.7914983021327,-27.4774672359806],[-58.7916231425065,-27.4779934053345],[-58.7918073095751,-27.4790601196506],[-58.7919914077944,-27.4801223234312],[-58.7931369438407,-27.4799632199458],[-58.7942015689479,-27.4798051502344],[-58.7951853567357,-27.4796526260957],[-58.796320841616,-27.4794981372397],[-58.7962162036306,-27.4789717123188],[-58.796136923083,-27.4784494709101],[-58.7969490632703,-27.4783171934086],[-58.7977513809474,-27.478203081701],[-58.7975977912417,-27.4771540257855],[-58.7974883132373,-27.4766411970091],[-58.7973985499764,-27.4760965371829],[-58.7972320675422,-27.4751874848063]]]}"
279,529,601,1130,302,292,17.77,64,"{""type"":""Polygon"",""coordinates"":[[[-58.7977513809474,-27.478203081701],[-58.7969490632703,-27.4783171934086],[-58.796136923083,-27.4784494709101],[-58.7962162036306,-27.4789717123188],[-58.796320841616,-27.4794981372397],[-58.7951853567357,-27.4796526260957],[-58.7942015689479,-27.4798051502344],[-58.7931369438407,-27.4799632199458],[-58.7919914077944,-27.4801223234312],[-58.7918251931918,-27.4801650616562],[-58.7920385395178,-27.4811592249896],[-58.7933308049423,-27.4810027410195],[-58.7935057583426,-27.4821237014868],[-58.7936657058533,-27.4829426243926],[-58.7938821266334,-27.4828766821826],[-58.7946825070557,-27.4826408176265],[-58.7952463109427,-27.4824756641266],[-58.7956490268992,-27.4823576959889],[-58.7967113276423,-27.4820552876565],[-58.7975320687892,-27.4818281660148],[-58.798337416213,-27.4815877058667],[-58.7981405769571,-27.48036779611],[-58.7979661667527,-27.4792829229384],[-58.7978615945179,-27.478761009558],[-58.7977513809474,-27.478203081701]]]}"
280,626,727,1353,364,353,16.02,84,"{""type"":""Polygon"",""coordinates"":[[[-58.7995151726303,-27.4746978748746],[-58.7986582139509,-27.474871343652],[-58.798245415565,-27.4749894498131],[-58.7979429065542,-27.4750474884874],[-58.7972320675422,-27.4751874848063],[-58.7973985499764,-27.4760965371829],[-58.7974883132373,-27.4766411970091],[-58.7975977912417,-27.4771540257855],[-58.7977513809474,-27.478203081701],[-58.7978615945179,-27.478761009558],[-58.7979661667527,-27.4792829229384],[-58.7981405769571,-27.48036779611],[-58.798337416213,-27.4815877058667],[-58.7993135898027,-27.4812773692405],[-58.8005116668146,-27.4809280681038],[-58.8004604349655,-27.4805768811598],[-58.8003862629588,-27.4800590878321],[-58.8003117984298,-27.4795232546093],[-58.8002072882771,-27.4790058534982],[-58.8001328989551,-27.4784745299745],[-58.8000483973148,-27.4779433371338],[-58.7999438170012,-27.4774214256337],[-58.799864447229,-27.4768946770802],[-58.7997799485316,-27.476363483842],[-58.7997054904855,-27.4758276497639],[-58.7996108074257,-27.4752920770775],[-58.7995151726303,-27.4746978748746]]]}"
283,753,884,1637,392,333,14.49,113,"{""type"":""Polygon"",""coordinates"":[[[-58.840713573397,-27.4850528228037],[-58.8403247994747,-27.4850940515614],[-58.8402591359905,-27.4850994307816],[-58.8399411569765,-27.4851397222271],[-58.8393909391057,-27.4852056371366],[-58.8386692381649,-27.4853008808511],[-58.8379576494071,-27.4853959872987],[-58.8380691966265,-27.486021520255],[-58.838082980397,-27.4862423691778],[-58.8381029446426,-27.486530798996],[-58.8381050034572,-27.4869593012429],[-58.8381220084241,-27.4873740735212],[-58.8381157147425,-27.4876042092855],[-58.83810949597,-27.4878388548897],[-58.8381470287499,-27.4882713992773],[-58.8381254882032,-27.4891061883245],[-58.8386453844543,-27.4890406784167],[-58.839185507915,-27.4889748992217],[-58.839331935615,-27.4889594311509],[-58.8398315272891,-27.488889674429],[-58.8403465141515,-27.4888332448063],[-58.841123787602,-27.4887327454982],[-58.8414417012219,-27.4886879410457],[-58.8418606787398,-27.4886372872769],[-58.8424714448028,-27.4885615386602],[-58.8424216788369,-27.488002854831],[-58.8423720637034,-27.4874531905878],[-58.8423169419031,-27.4868765341983],[-58.8422967894526,-27.4868813118439],[-58.8412521155393,-27.4870214424669],[-58.8411871112555,-27.4864584486418],[-58.8411372033039,-27.4858907441486],[-58.840814015615,-27.4859220849083],[-58.840713573397,-27.4850528228037]]]}"
284,534,598,1132,334,371,11.82,96,"{""type"":""Polygon"",""coordinates"":[[[-58.8443334343858,-27.4846530482662],[-58.8435864589592,-27.4847486522202],[-58.843146969631,-27.4847815390259],[-58.8430510409482,-27.4847918312501],[-58.8424199187941,-27.4848588295443],[-58.8417787571606,-27.4849304687085],[-58.8414052296667,-27.4849760094979],[-58.8410366085723,-27.485012462716],[-58.840713573397,-27.4850528228037],[-58.840814015615,-27.4859220849083],[-58.8411372033039,-27.4858907441486],[-58.8411871112555,-27.4864584486418],[-58.8412521155393,-27.4870214424669],[-58.8422967894526,-27.4868813118439],[-58.8423169419031,-27.4868765341983],[-58.8423720637034,-27.4874531905878],[-58.8424216788369,-27.488002854831],[-58.8424714448028,-27.4885615386602],[-58.8433447957542,-27.488459754815],[-58.8440764751992,-27.4883553323646],[-58.8448082282108,-27.4882554159601],[-58.8446867722201,-27.4873413285278],[-58.8445615396355,-27.4865039749303],[-58.8444227385255,-27.485459302835],[-58.8443528882739,-27.4849099076385],[-58.8443334343858,-27.4846530482662]]]}"
285,219,312,531,177,179,7.42,72,"{""type"":""Polygon"",""coordinates"":[[[-58.8456151470773,-27.4844736651518],[-58.8449690842229,-27.4845544055429],[-58.8443334343858,-27.4846530482662],[-58.8443528882739,-27.4849099076385],[-58.8444227385255,-27.485459302835],[-58.8445615396355,-27.4865039749303],[-58.8446867722201,-27.4873413285278],[-58.8448082282108,-27.4882554159601],[-58.8455247336684,-27.4881511871595],[-58.8455600569676,-27.488146207823],[-58.846261465246,-27.4880466863392],[-58.8468520714546,-27.4879756970039],[-58.8467002578738,-27.4870620148156],[-58.8466380854521,-27.4866703982635],[-58.8469900619349,-27.485939484176],[-58.8467253010081,-27.4858347383795],[-58.8458443784146,-27.4854810497085],[-58.8457550282639,-27.4852792477331],[-58.8456151470773,-27.4844736651518]]]}"
286,1110,1065,2175,438,391,12.83,170,"{""type"":""Polygon"",""coordinates"":[[[-58.8495497930392,-27.4829373646066],[-58.8481823458115,-27.4837359046396],[-58.8476808142122,-27.4839906599403],[-58.8472244146205,-27.4842222602922],[-58.8469485512171,-27.4843612466723],[-58.8462874705517,-27.4844512141084],[-58.8456765802509,-27.4845179586225],[-58.8456151470773,-27.4844736651518],[-58.8457550282639,-27.4852792477331],[-58.8458443784146,-27.4854810497085],[-58.8467253010081,-27.4858347383795],[-58.8469900619349,-27.485939484176],[-58.8481868500902,-27.4864288058195],[-58.8488692134075,-27.4867039226925],[-58.8494653871504,-27.4869666492293],[-58.8496994350345,-27.4870492437783],[-58.850239232799,-27.4872676080676],[-58.8507789571708,-27.487481460336],[-58.8506349594467,-27.4867345798388],[-58.8505767701488,-27.4865819859144],[-58.8504499062138,-27.4859521584693],[-58.8503721741053,-27.4855381968041],[-58.850306893448,-27.4852639048856],[-58.8501579967174,-27.484526110242],[-58.8500407177236,-27.4841668038703],[-58.8499827569321,-27.484027738992],[-58.8498699328679,-27.4836322866231],[-58.8498284993723,-27.4835741967291],[-58.849758617007,-27.4833270304898],[-58.8497002048899,-27.4831609065211],[-58.8496483568543,-27.483084911702],[-58.8495756792987,-27.4829731071316],[-58.8495497930392,-27.4829373646066]]]}"
287,672,727,1399,353,368,25.99,54,"{""type"":""Polygon"",""coordinates"":[[[-58.8567533912908,-27.4818084616578],[-58.8559230487506,-27.481756386317],[-58.8553905174054,-27.4816687601091],[-58.8552835728268,-27.4816250777409],[-58.8547026617302,-27.4813666828496],[-58.8546234940576,-27.4814714866593],[-58.8545128533073,-27.4815090476111],[-58.8543558720292,-27.4814976069926],[-58.854238588154,-27.4814405291199],[-58.8541711905035,-27.4813421891559],[-58.85412417041,-27.4812525992965],[-58.8541122443552,-27.4811444986033],[-58.8538128484506,-27.4810853356717],[-58.8536346597514,-27.4810155360921],[-58.8531443978124,-27.4810355976869],[-58.8530584358954,-27.4810367423209],[-58.8529653791862,-27.4809161892857],[-58.8528732285005,-27.4808497539326],[-58.8525802489838,-27.4808716975961],[-58.8516481788885,-27.4807848639632],[-58.8514177637114,-27.4809187432455],[-58.851178290615,-27.4811158941357],[-58.8510345150429,-27.4812892177138],[-58.8507880187294,-27.4816714050375],[-58.8505627274466,-27.4821119506599],[-58.850326190338,-27.4824849831713],[-58.8495497930392,-27.4829373646066],[-58.8495756792987,-27.4829731071316],[-58.8496483568543,-27.483084911702],[-58.8497002048899,-27.4831609065211],[-58.849758617007,-27.4833270304898],[-58.8498284993723,-27.4835741967291],[-58.8498699328679,-27.4836322866231],[-58.8499827569321,-27.484027738992],[-58.8500407177236,-27.4841668038703],[-58.8501579967174,-27.484526110242],[-58.850306893448,-27.4852639048856],[-58.8503721741053,-27.4855381968041],[-58.8510324270159,-27.4853986018481],[-58.8516878476485,-27.4852726005665],[-58.8523785130606,-27.4851371054486],[-58.8530389114954,-27.4850065208237],[-58.8536838357919,-27.484858095989],[-58.8537956131716,-27.4848881826553],[-58.8539410504662,-27.4848140720613],[-58.8540507881305,-27.4847223937184],[-58.8542070184794,-27.4846887363804],[-58.8543529085611,-27.4846416842216],[-58.8545239310913,-27.4845852753496],[-58.8547811447072,-27.4845412499146],[-58.8549022796908,-27.4845261028378],[-58.8550137546644,-27.4845381493058],[-58.8551191902733,-27.4844916356323],[-58.8554018382301,-27.4844562916159],[-58.8556892402579,-27.4844028403869],[-58.8558767929554,-27.4844274040586],[-58.8562133355184,-27.484589815306],[-58.8566710139086,-27.4847370770702],[-58.8566895765192,-27.4846375915743],[-58.856594953458,-27.4832179486712],[-58.8567508427128,-27.4822595768229],[-58.856749405418,-27.4821738905809],[-58.8567533912908,-27.4818084616578]]]}"
296,1005,1035,2040,474,457,16.6,123,"{""type"":""Polygon"",""coordinates"":[[[-58.8122048377594,-27.4938758738719],[-58.8120477664379,-27.4938598762525],[-58.8117628598398,-27.4937598367011],[-58.8114574668554,-27.4939532698814],[-58.811515164631,-27.4940788230048],[-58.8110532891117,-27.4942923362545],[-58.810272210259,-27.4944739148588],[-58.8100520493083,-27.4946211273096],[-58.8098960837527,-27.4946727759869],[-58.8097135772849,-27.494648084903],[-58.8096370534561,-27.4946084824427],[-58.8096555861025,-27.494504491304],[-58.8095891770352,-27.4944647572447],[-58.8095586855874,-27.4944561320967],[-58.809507964866,-27.4944477700531],[-58.8090327242391,-27.4944629721527],[-58.8086650142651,-27.4945579704766],[-58.8085089006123,-27.4946005977933],[-58.8082768531404,-27.4946397010415],[-58.8080498628159,-27.4946787381852],[-58.8081266810034,-27.4947363812119],[-58.8082192159391,-27.4951366463979],[-58.8081610623822,-27.495602022307],[-58.8081477329976,-27.4957149674095],[-58.8091161686576,-27.4955444967191],[-58.8092125537098,-27.4955612867944],[-58.8093851908465,-27.496528879176],[-58.8096079964837,-27.4977800034123],[-58.8096642926741,-27.4978198689297],[-58.8097257536023,-27.4981754281885],[-58.8099122165877,-27.4981324045076],[-58.809927389048,-27.4981322071061],[-58.8099430383565,-27.4984703187706],[-58.8098361267828,-27.4987378510795],[-58.8098582015738,-27.4988503356355],[-58.8099747802198,-27.4991736014912],[-58.8101268752454,-27.4991941768104],[-58.8112062334689,-27.4989996929227],[-58.8114986834809,-27.4989417544908],[-58.8117508207571,-27.4988933622244],[-58.8122621395615,-27.4983002892223],[-58.8127333628001,-27.4977302912954],[-58.8126924179945,-27.4973925098181],[-58.8126452337133,-27.4969826357298],[-58.8125010314681,-27.4962086453466],[-58.8123759862276,-27.4950600030098],[-58.8122048377594,-27.4938758738719]]]}"
315,849,861,1710,392,410,33.97,50,"{""type"":""Polygon"",""coordinates"":[[[-58.7925335308482,-27.520135994632],[-58.7925074953839,-27.5204024723475],[-58.7924862258009,-27.520650845082],[-58.7924186129521,-27.5211614464215],[-58.7924098855844,-27.5212472656903],[-58.7923708683279,-27.5216492371742],[-58.7923136644656,-27.5221777477713],[-58.7921888456003,-27.5232168595274],[-58.7920696688459,-27.5242919854297],[-58.7919443344837,-27.5252995273276],[-58.7927092344012,-27.5253528181771],[-58.7925688019768,-27.5263650659148],[-58.792522813234,-27.5269610948869],[-58.7923932903286,-27.5283340719235],[-58.792502088675,-27.5284905497608],[-58.7933646530659,-27.5292598061041],[-58.7949197457405,-27.5278052768858],[-58.7953754890541,-27.5272039562365],[-58.7958700861734,-27.5261916427602],[-58.7966014831492,-27.5251176263338],[-58.7972028829556,-27.5244512655615],[-58.797170990204,-27.524356949506],[-58.7971355033626,-27.5240416470983],[-58.7971328627897,-27.5238792897817],[-58.796565627605,-27.5235347728473],[-58.7965926067435,-27.5233269239721],[-58.7965311688478,-27.5229713587726],[-58.796458440825,-27.5222325149842],[-58.7963536027046,-27.5220083257947],[-58.7962497184996,-27.5215315151118],[-58.7959519970855,-27.5209579689737],[-58.7954267879413,-27.5207076321814],[-58.7948222556672,-27.5205575566473],[-58.7945625849973,-27.5204571582585],[-58.7944385435661,-27.520296367549],[-58.7942760111741,-27.520257867197],[-58.7936686200043,-27.5202431498084],[-58.7925335308482,-27.520135994632]]]}"
288,794,819,1613,375,386,33.02,49,"{""type"":""Polygon"",""coordinates"":[[[-58.8566710139086,-27.4847370770702],[-58.8562133355184,-27.484589815306],[-58.8558767929554,-27.4844274040586],[-58.8556892402579,-27.4844028403869],[-58.8554018382301,-27.4844562916159],[-58.8551191902733,-27.4844916356323],[-58.8550137546644,-27.4845381493058],[-58.8549022796908,-27.4845261028378],[-58.8547811447072,-27.4845412499146],[-58.8545239310913,-27.4845852753496],[-58.8543529085611,-27.4846416842216],[-58.8542070184794,-27.4846887363804],[-58.8540507881305,-27.4847223937184],[-58.8539410504662,-27.4848140720613],[-58.8537956131716,-27.4848881826553],[-58.8536838357919,-27.484858095989],[-58.8530389114954,-27.4850065208237],[-58.8523785130606,-27.4851371054486],[-58.8516878476485,-27.4852726005665],[-58.8510324270159,-27.4853986018481],[-58.8503721741053,-27.4855381968041],[-58.8504499062138,-27.4859521584693],[-58.8505767701488,-27.4865819859144],[-58.8506349594467,-27.4867345798388],[-58.8507789571708,-27.487481460336],[-58.8514259345368,-27.4877570348179],[-58.8517772750583,-27.4878967056319],[-58.8517128916304,-27.4885832063969],[-58.8516799068739,-27.4890302160563],[-58.8516368080164,-27.4894773602885],[-58.8516323547395,-27.4895135060704],[-58.851593255121,-27.4901996702241],[-58.8515853295227,-27.4903305893144],[-58.8515329461189,-27.4908274759851],[-58.8514586728416,-27.4915276405421],[-58.8528883117832,-27.4914183924905],[-58.8537016668452,-27.491357939395],[-58.854610348742,-27.4912511028231],[-58.8547888415149,-27.4907344911808],[-58.854955639365,-27.4904255324862],[-58.8550840217159,-27.4902388776566],[-58.8551284005954,-27.490170623814],[-58.8552954235567,-27.4898751941802],[-58.8554390512668,-27.4896928465771],[-58.8555775459267,-27.4895060564846],[-58.8556108271959,-27.4893793099845],[-58.8556820683474,-27.4891032005197],[-58.8557328545766,-27.4888138314036],[-58.8558132360598,-27.4887811836654],[-58.8558112696837,-27.488663928855],[-58.855864475635,-27.4885188733155],[-58.8558796463864,-27.4885186709687],[-58.8560748995077,-27.4883987855137],[-58.8560690862045,-27.48835375497],[-58.856056703233,-27.4882185958794],[-58.8562133915701,-27.4882119948883],[-58.8562726371046,-27.4881254991557],[-58.8562018405304,-27.4881264436138],[-58.8561990417219,-27.4879595810195],[-58.8561354846995,-27.4877890181161],[-58.8561148033324,-27.4877622291406],[-58.8561044626527,-27.4877488346514],[-58.8560941219755,-27.4877354401613],[-58.8560837056632,-27.48771753587],[-58.8560784218709,-27.4877040739235],[-58.8560781949587,-27.4876905445224],[-58.8560779680467,-27.4876770151212],[-58.8560772873117,-27.4876364269175],[-58.8560770604003,-27.4876228975163],[-58.8560818903642,-27.4876093006606],[-58.8560866446895,-27.4875911940043],[-58.8561013614842,-27.4875639328372],[-58.8561061914428,-27.4875503359808],[-58.8561108701241,-27.4875277195235],[-58.8561152462506,-27.4874870638644],[-58.8561200762047,-27.4874734670076],[-58.8561248305193,-27.4874553603503],[-58.8561294335552,-27.487428234092],[-58.8561340365893,-27.4874011078336],[-58.8561388665379,-27.4873875109763],[-58.8561436208465,-27.4873694043185],[-58.856143167013,-27.4873423455159],[-58.8561477700413,-27.487315219257],[-58.8561475431245,-27.4873016898556],[-58.8561473162078,-27.4872881604542],[-58.8561470136524,-27.4872701212523],[-58.8561416542388,-27.4872521495063],[-58.8561411247695,-27.4872205809027],[-58.8561458790723,-27.4872024742447],[-58.8561507090123,-27.4871888773871],[-58.8561602932501,-27.4871571738711],[-58.8561651231868,-27.4871435770132],[-58.8561699531223,-27.4871299801551],[-58.8561747830567,-27.4871163832969],[-58.8561744804991,-27.4870983440948],[-58.8561791591528,-27.4870757276355],[-58.8561787053162,-27.4870486688322],[-58.8562137250557,-27.4870256476282],[-58.8562236874693,-27.4870164931111],[-58.8562488204224,-27.4870071362165],[-58.8562587828314,-27.486997981697],[-58.8562687452388,-27.4869888271769],[-58.8562936512499,-27.4869659408738],[-58.8563083679187,-27.4869386796891],[-58.8563181790273,-27.4869205055653],[-58.8563179520934,-27.4869069761645],[-58.8563227820013,-27.4868933793021],[-58.8563275362632,-27.4868752726393],[-58.8563220255547,-27.4868482812991],[-58.8563167417821,-27.4868348193596],[-58.8563114580108,-27.4868213574197],[-58.8562909280845,-27.4868035880608],[-58.8562753793591,-27.4867812414384],[-58.8562597549984,-27.4867543850134],[-58.8562493387623,-27.4867364807289],[-58.8562440550046,-27.4867230187856],[-58.8562387712482,-27.4867095568421],[-58.8562433742363,-27.4866824305801],[-58.8562430716731,-27.4866643913776],[-58.8562476746589,-27.4866372651156],[-58.8562523532839,-27.486614648654],[-58.8562519750791,-27.4865920996508],[-58.8562517481565,-27.4865785702488],[-58.8562513699525,-27.4865560212455],[-58.8562560485743,-27.4865334047837],[-58.8562557460109,-27.486515365581],[-58.8562605002716,-27.4864972589198],[-58.8562602733488,-27.4864837295177],[-58.8562650276077,-27.4864656228564],[-58.8562647250437,-27.4864475836536],[-58.8562695549417,-27.4864339867929],[-58.8562794416588,-27.4864203224731],[-58.8562842715539,-27.486406725612],[-58.8562889501645,-27.4863841091494],[-58.8562887232394,-27.4863705797472],[-58.8562933262062,-27.4863434534838],[-58.8563081184441,-27.4863207021016],[-58.856317778219,-27.4862935083776],[-58.8563275892754,-27.4862753342545],[-58.8563374003288,-27.4862571601307],[-58.8563422302108,-27.486243563268],[-58.8563520412592,-27.4862253891434],[-58.8563669091147,-27.4862071475566],[-58.8563817769653,-27.4861889059684],[-58.8563915880028,-27.4861707318415],[-58.8564013233915,-27.4861480479134],[-58.8564210967428,-27.4861207192576],[-58.8564309834149,-27.4861070549288],[-58.8564358132798,-27.4860934580635],[-58.8564406431436,-27.486079861198],[-58.8564454730064,-27.4860662643323],[-58.8564503028681,-27.4860526674665],[-58.8564500759264,-27.486039138065],[-58.8564549057866,-27.4860255411991],[-58.8564546788446,-27.4860120117976],[-58.8564493951025,-27.4859985498604],[-58.8564389789153,-27.4859806455861],[-58.8564284870857,-27.4859582315103],[-58.8564181465516,-27.4859448370347],[-58.8564078816653,-27.4859359523589],[-58.8563975411359,-27.4859225578815],[-58.8563769357285,-27.4859002787248],[-58.8563616140539,-27.4858914615063],[-58.856351349177,-27.4858825768258],[-58.8563308194283,-27.4858648074622],[-58.856320478915,-27.4858514129781],[-58.8563101384043,-27.4858380184932],[-58.8562997222559,-27.4858201142063],[-58.8562940603426,-27.4857841032561],[-58.8562887009924,-27.4857661315098],[-58.8562883984336,-27.4857480923053],[-58.8562881715147,-27.485734562902],[-58.8562878689564,-27.4857165236975],[-58.8562924719062,-27.485689397433],[-58.8562970748541,-27.4856622711683],[-58.856296847935,-27.4856487417648],[-58.8563016021603,-27.4856306351023],[-58.8563012996012,-27.4856125958977],[-58.8563009970423,-27.485594556693],[-58.8563057512652,-27.4855764500304],[-58.8563055243459,-27.4855629206268],[-58.8563103542069,-27.4855493237652],[-58.8563101272872,-27.4855357943616],[-58.8563097490881,-27.4855132453557],[-58.8563095221689,-27.485499715952],[-58.8563192575243,-27.4854770320297],[-58.8563240873806,-27.4854634351677],[-58.8563338983708,-27.4854452610457],[-58.8563387282241,-27.4854316641834],[-58.8563484635683,-27.4854089802593],[-58.8563482366454,-27.4853954508558],[-58.8563480097225,-27.4853819214522],[-58.8565934463815,-27.4852388119157],[-58.8566710139086,-27.4847370770702]]]}"
289,498,525,1023,282,285,23.66,43,"{""type"":""Polygon"",""coordinates"":[[[-58.8469900619349,-27.485939484176],[-58.8466380854521,-27.4866703982635],[-58.8467002578738,-27.4870620148156],[-58.8468520714546,-27.4879756970039],[-58.847296026261,-27.4879066522172],[-58.848184310536,-27.4877911075748],[-58.8484750760837,-27.4891495128573],[-58.8471235721341,-27.4893930020409],[-58.8465183897274,-27.4895002728029],[-58.8466740592353,-27.4903417305138],[-58.8472393921248,-27.4902710745566],[-58.8472384629996,-27.4908214070133],[-58.8472428922638,-27.4913897115698],[-58.8472122858618,-27.4922832602732],[-58.8477014702389,-27.4921955698254],[-58.849057385242,-27.4919114179447],[-58.8507325670721,-27.4916636038884],[-58.8514586728416,-27.4915276405421],[-58.8515329461189,-27.4908274759851],[-58.8515853295227,-27.4903305893144],[-58.851593255121,-27.4901996702241],[-58.8516323547395,-27.4895135060704],[-58.8516368080164,-27.4894773602885],[-58.8516799068739,-27.4890302160563],[-58.8517128916304,-27.4885832063969],[-58.8517772750583,-27.4878967056319],[-58.8514259345368,-27.4877570348179],[-58.8507789571708,-27.487481460336],[-58.850239232799,-27.4872676080676],[-58.8496994350345,-27.4870492437783],[-58.8494653871504,-27.4869666492293],[-58.8488692134075,-27.4867039226925],[-58.8481868500902,-27.4864288058195],[-58.8469900619349,-27.485939484176]]]}"
290,777,801,1578,407,355,18.23,87,"{""type"":""Polygon"",""coordinates"":[[[-58.8468520714546,-27.4879756970039],[-58.846261465246,-27.4880466863392],[-58.8455600569676,-27.488146207823],[-58.8455247336684,-27.4881511871595],[-58.8448082282108,-27.4882554159601],[-58.8440764751992,-27.4883553323646],[-58.8433447957542,-27.488459754815],[-58.8435309084167,-27.4896120608068],[-58.8437215567316,-27.4907327303559],[-58.8439119089755,-27.4918353599677],[-58.8440858164063,-27.4928615229898],[-58.8447916365118,-27.4927213519802],[-58.8455432697045,-27.4925986130328],[-58.8457398207961,-27.4925554082516],[-58.8462641067162,-27.4924492138242],[-58.8466322982584,-27.4923856867247],[-58.8472122858618,-27.4922832602732],[-58.8472428922638,-27.4913897115698],[-58.8472384629996,-27.4908214070133],[-58.8472393921248,-27.4902710745566],[-58.8466740592353,-27.4903417305138],[-58.8465183897274,-27.4895002728029],[-58.8471235721341,-27.4893930020409],[-58.8484750760837,-27.4891495128573],[-58.848184310536,-27.4877911075748],[-58.847296026261,-27.4879066522172],[-58.8468520714546,-27.4879756970039]]]}"
291,764,825,1589,400,342,15.65,102,"{""type"":""Polygon"",""coordinates"":[[[-58.8433447957542,-27.488459754815],[-58.8424714448028,-27.4885615386602],[-58.8418606787398,-27.4886372872769],[-58.8414417012219,-27.4886879410457],[-58.841123787602,-27.4887327454982],[-58.8403465141515,-27.4888332448063],[-58.840405109245,-27.4893151287656],[-58.8404826264881,-27.4900223039034],[-58.8405424983511,-27.4905808549162],[-58.8406175422328,-27.4911392051301],[-58.840682397809,-27.4916931791955],[-58.8407422721007,-27.4922517299012],[-58.8408544146398,-27.4932155635229],[-58.8408731128491,-27.4934273250506],[-58.8417610749933,-27.4932892698452],[-58.8418770897176,-27.4932696906858],[-58.8426134090954,-27.4931381484298],[-58.843334479881,-27.4930022935405],[-58.8438790745266,-27.4929003497081],[-58.8440858164063,-27.4928615229898],[-58.8439119089755,-27.4918353599677],[-58.8437215567316,-27.4907327303559],[-58.8435309084167,-27.4896120608068],[-58.8433447957542,-27.488459754815]]]}"
292,885,878,1763,409,339,11.74,150,"{""type"":""Polygon"",""coordinates"":[[[-58.8403465141515,-27.4888332448063],[-58.8398315272891,-27.488889674429],[-58.839331935615,-27.4889594311509],[-58.839185507915,-27.4889748992217],[-58.8386453844543,-27.4890406784167],[-58.8381254882032,-27.4891061883245],[-58.8381222281152,-27.4898234540987],[-58.8381257112235,-27.4903376431911],[-58.8381132741325,-27.490806934232],[-58.8381115505818,-27.4913121703786],[-58.8381143225226,-27.4914790345985],[-58.8381048449573,-27.4918219831455],[-58.8380987013947,-27.4920611384705],[-58.838093906389,-27.4923814709666],[-58.8381027095499,-27.4926068963098],[-58.8380927076175,-27.49291827591],[-58.8381090405218,-27.4932924592274],[-58.8387057883497,-27.4932845738726],[-58.8388574289068,-27.4932780588731],[-58.8396561636938,-27.4932494562902],[-58.8402426463952,-27.4932326784223],[-58.8408544146398,-27.4932155635229],[-58.8407422721007,-27.4922517299012],[-58.840682397809,-27.4916931791955],[-58.8406175422328,-27.4911392051301],[-58.8405424983511,-27.4905808549162],[-58.8404826264881,-27.4900223039034],[-58.840405109245,-27.4893151287656],[-58.8403465141515,-27.4888332448063]]]}"
293,292,301,593,175,185,11.27,53,"{""type"":""Polygon"",""coordinates"":[[[-58.8198190457864,-27.4911917633697],[-58.8192384534045,-27.4909512586631],[-58.8185458655409,-27.4906671066594],[-58.8182238220784,-27.4910772930988],[-58.8173367410012,-27.4921940442157],[-58.8171906748907,-27.4922320389589],[-58.8170810459481,-27.4923327097705],[-58.8161780315241,-27.493404553529],[-58.815940094693,-27.4937008655484],[-58.8155586037234,-27.4941885069318],[-58.8155090419839,-27.49455904459],[-58.8155646476696,-27.4948650577199],[-58.8157051438054,-27.4957202882763],[-58.8159543416846,-27.4970342076076],[-58.8158866470568,-27.4972245474698],[-58.8166177425323,-27.4961549499673],[-58.8169929183633,-27.4955907035561],[-58.8175111965889,-27.4948080654448],[-58.8179160403529,-27.4942028314331],[-58.8179703365871,-27.4941209264446],[-58.8186066394813,-27.4931337535859],[-58.8189276490368,-27.4926604276746],[-58.819460182279,-27.4918234662826],[-58.8197214629921,-27.4914095609647],[-58.8198190457864,-27.4911917633697]]]}"
294,503,556,1059,275,256,14.11,75,"{""type"":""Polygon"",""coordinates"":[[[-58.8171906748907,-27.4922320389589],[-58.8170057911475,-27.4911383136439],[-58.8154811216992,-27.4913160966755],[-58.8149054190715,-27.4913732269957],[-58.8143904756731,-27.4914340734991],[-58.8145746687805,-27.492487214353],[-58.8147337276171,-27.4935497042736],[-58.8143753274546,-27.4935949764723],[-58.8141581607546,-27.4936158518689],[-58.8136332397186,-27.4936858477711],[-58.8128911505269,-27.4937767151676],[-58.8125427153901,-27.4938128311025],[-58.8122048377594,-27.4938758738719],[-58.8123759862276,-27.4950600030098],[-58.8125010314681,-27.4962086453466],[-58.8126452337133,-27.4969826357298],[-58.8126924179945,-27.4973925098181],[-58.8127333628001,-27.4977302912954],[-58.8133677801979,-27.4969326214528],[-58.814046447895,-27.4960576872399],[-58.8146362921629,-27.4953192345493],[-58.815163121397,-27.4947485037418],[-58.81531128898,-27.4945300489911],[-58.8155586037234,-27.4941885069318],[-58.815940094693,-27.4937008655484],[-58.8161780315241,-27.493404553529],[-58.8170810459481,-27.4923327097705],[-58.8171906748907,-27.4922320389589]]]}"
295,726,794,1520,369,360,12.6,121,"{""type"":""Polygon"",""coordinates"":[[[-58.8143904756731,-27.4914340734991],[-58.8138200505529,-27.4915046631477],[-58.8132900080804,-27.4915702133222],[-58.812058419682,-27.4917306066403],[-58.8122716052138,-27.4927021780034],[-58.8110942293564,-27.4927761505137],[-58.8099987263399,-27.4929076893635],[-58.8087665268086,-27.4930319751211],[-58.8086396530512,-27.4930065592475],[-58.8076664022244,-27.4931906211083],[-58.8078528389805,-27.4937655908003],[-58.8079436768878,-27.4940621281965],[-58.80799896669,-27.4943501057241],[-58.8080498628159,-27.4946787381852],[-58.8082768531404,-27.4946397010415],[-58.8085089006123,-27.4946005977933],[-58.8086650142651,-27.4945579704766],[-58.8090327242391,-27.4944629721527],[-58.809507964866,-27.4944477700531],[-58.8095586855874,-27.4944561320967],[-58.8095891770352,-27.4944647572447],[-58.8096555861025,-27.494504491304],[-58.8096370534561,-27.4946084824427],[-58.8097135772849,-27.494648084903],[-58.8098960837527,-27.4946727759869],[-58.8100520493083,-27.4946211273096],[-58.810272210259,-27.4944739148588],[-58.8110532891117,-27.4942923362545],[-58.811515164631,-27.4940788230048],[-58.8114574668554,-27.4939532698814],[-58.8117628598398,-27.4937598367011],[-58.8120477664379,-27.4938598762525],[-58.8122048377594,-27.4938758738719],[-58.8125427153901,-27.4938128311025],[-58.8128911505269,-27.4937767151676],[-58.8136332397186,-27.4936858477711],[-58.8141581607546,-27.4936158518689],[-58.8143753274546,-27.4935949764723],[-58.8147337276171,-27.4935497042736],[-58.8145746687805,-27.492487214353],[-58.8143904756731,-27.4914340734991]]]}"
314,848,853,1701,352,368,16.78,101,"{""type"":""Polygon"",""coordinates"":[[[-58.7923708683279,-27.5216492371742],[-58.7911956618857,-27.5215651431294],[-58.7900252960965,-27.5214674440981],[-58.7888594793756,-27.5213381003916],[-58.7877144828755,-27.5212445662047],[-58.7876464098998,-27.5217281065464],[-58.7876144765582,-27.5222562910625],[-58.7875476430083,-27.5228165004878],[-58.7875006789917,-27.5233538999613],[-58.7874025437833,-27.5238558701943],[-58.7873656964197,-27.5243931395218],[-58.7884599920836,-27.5244783058974],[-58.7896559022427,-27.5245892208438],[-58.7908569460444,-27.5247045701572],[-58.7907893242583,-27.5252151708981],[-58.7919443344837,-27.5252995273276],[-58.7920696688459,-27.5242919854297],[-58.7921888456003,-27.5232168595274],[-58.7923136644656,-27.5221777477713],[-58.7923708683279,-27.5216492371742]]]}"
297,743,713,1456,309,296,15.6,93,"{""type"":""Polygon"",""coordinates"":[[[-58.8076664022244,-27.4931906211083],[-58.8071215431495,-27.493278895047],[-58.8066875749839,-27.4933431725311],[-58.8061934342217,-27.4934398060136],[-58.8058505694863,-27.4935074090451],[-58.8057670246135,-27.4936573524227],[-58.8060547462115,-27.4942400319142],[-58.8061300397159,-27.4945142180338],[-58.8063826587231,-27.4951153958529],[-58.8064248112667,-27.4952185987078],[-58.8067310273495,-27.4960040257048],[-58.8068360791727,-27.4962417377962],[-58.8071803557978,-27.49718906066],[-58.8073385367327,-27.4972727123371],[-58.8073919112805,-27.4974434321331],[-58.8074749676314,-27.4975731683853],[-58.8075382364367,-27.4977302269292],[-58.8075425842618,-27.4979963120024],[-58.806693883725,-27.498065978273],[-58.8068682212168,-27.4985193123378],[-58.8069951269383,-27.4988559795134],[-58.8070533383846,-27.499013103944],[-58.8072777656185,-27.4997454607924],[-58.8078524117751,-27.499620711105],[-58.8083766284285,-27.4995056364132],[-58.8092290680459,-27.4993547152225],[-58.8101268752454,-27.4991941768104],[-58.8099747802198,-27.4991736014912],[-58.8098582015738,-27.4988503356355],[-58.8098361267828,-27.4987378510795],[-58.8099430383565,-27.4984703187706],[-58.809927389048,-27.4981322071061],[-58.8099122165877,-27.4981324045076],[-58.8097257536023,-27.4981754281885],[-58.8096642926741,-27.4978198689297],[-58.8096079964837,-27.4977800034123],[-58.8093851908465,-27.496528879176],[-58.8092125537098,-27.4955612867944],[-58.8091161686576,-27.4955444967191],[-58.8081477329976,-27.4957149674095],[-58.8081610623822,-27.495602022307],[-58.8082192159391,-27.4951366463979],[-58.8081266810034,-27.4947363812119],[-58.8080498628159,-27.4946787381852],[-58.80799896669,-27.4943501057241],[-58.8079436768878,-27.4940621281965],[-58.8078528389805,-27.4937655908003],[-58.8076664022244,-27.4931906211083]]]}"
298,719,678,1397,310,297,12.13,115,"{""type"":""Polygon"",""coordinates"":[[[-58.8058505694863,-27.4935074090451],[-58.8050837208088,-27.4939413831752],[-58.8047422514459,-27.4940946721664],[-58.8044207897366,-27.4942341682143],[-58.8041747458861,-27.4943456202608],[-58.8035672935409,-27.4946286601549],[-58.8037340388433,-27.4946174766536],[-58.8041144769461,-27.4953027085197],[-58.8043072633092,-27.4956475461209],[-58.8047704668631,-27.4964444743638],[-58.8050057773285,-27.4969150637194],[-58.8056608517826,-27.4983094454248],[-58.8057817614615,-27.4988988007396],[-58.8058533995444,-27.4992587408442],[-58.8059218720188,-27.4994247543354],[-58.806041017356,-27.4999058711548],[-58.8063899902435,-27.4999013399405],[-58.8067380790628,-27.4998426888454],[-58.8072777656185,-27.4997454607924],[-58.8070533383846,-27.499013103944],[-58.8069951269383,-27.4988559795134],[-58.8068682212168,-27.4985193123378],[-58.806693883725,-27.498065978273],[-58.8075425842618,-27.4979963120024],[-58.8075382364367,-27.4977302269292],[-58.8074749676314,-27.4975731683853],[-58.8073919112805,-27.4974434321331],[-58.8073385367327,-27.4972727123371],[-58.8071803557978,-27.49718906066],[-58.8068360791727,-27.4962417377962],[-58.8067310273495,-27.4960040257048],[-58.8064248112667,-27.4952185987078],[-58.8063826587231,-27.4951153958529],[-58.8061300397159,-27.4945142180338],[-58.8060547462115,-27.4942400319142],[-58.8057670246135,-27.4936573524227],[-58.8058505694863,-27.4935074090451]]]}"
299,1085,1087,2172,486,501,44.07,49,"{""type"":""Polygon"",""coordinates"":[[[-58.8035672935409,-27.4946286601549],[-58.8025934430054,-27.4950878588681],[-58.8011823076888,-27.4957196158843],[-58.8002527794944,-27.4961060507941],[-58.800266123507,-27.4963043570742],[-58.7995497334789,-27.4967331380926],[-58.798572842167,-27.4973186539112],[-58.798075376849,-27.4975235636343],[-58.7976277517547,-27.4976827187278],[-58.7972556948418,-27.4978228525964],[-58.7970221751268,-27.4971492359276],[-58.7969268156173,-27.4971955765907],[-58.7963931393997,-27.4973513283142],[-58.7958091062319,-27.4975212607681],[-58.7950037116759,-27.4977662215188],[-58.7941681144476,-27.4980205890363],[-58.794649055915,-27.4992909678441],[-58.7947515162573,-27.4996820935078],[-58.7950175776802,-27.5001793694239],[-58.7950799525451,-27.5002823150067],[-58.7956521116899,-27.500938031174],[-58.7959200892413,-27.5012413120895],[-58.796074895159,-27.5014287706479],[-58.7962486872101,-27.5015392987435],[-58.7965466508059,-27.5015083854209],[-58.7973440048767,-27.5013898237272],[-58.7975517358427,-27.5014096938946],[-58.7986466831555,-27.5012376590742],[-58.7991561862541,-27.5011498741471],[-58.799847029916,-27.501014632303],[-58.7999075015024,-27.5010003172006],[-58.8007752869802,-27.5008582702957],[-58.8009569947328,-27.5008333634533],[-58.8014410585883,-27.5007368778658],[-58.8019405882632,-27.5006582337998],[-58.8019468094737,-27.5004190765469],[-58.8030029384329,-27.4997287596813],[-58.8033233148033,-27.4995216172735],[-58.8036841504183,-27.4993139495734],[-58.8043100920905,-27.4989224075621],[-58.8039077909758,-27.4981382212002],[-58.8037763360842,-27.4975219352703],[-58.8037323465754,-27.4973059834107],[-58.8044172928882,-27.4971211766078],[-58.8041887158859,-27.4964429984104],[-58.8038854575701,-27.495837962131],[-58.8043072633092,-27.4956475461209],[-58.8041144769461,-27.4953027085197],[-58.8037340388433,-27.4946174766536],[-58.8035672935409,-27.4946286601549]]]}"
300,601,592,1193,274,272,22.98,52,"{""type"":""Polygon"",""coordinates"":[[[-58.8043072633092,-27.4956475461209],[-58.8038854575701,-27.495837962131],[-58.8041887158859,-27.4964429984104],[-58.8044172928882,-27.4971211766078],[-58.8037323465754,-27.4973059834107],[-58.8037763360842,-27.4975219352703],[-58.8039077909758,-27.4981382212002],[-58.8043100920905,-27.4989224075621],[-58.8036841504183,-27.4993139495734],[-58.8033233148033,-27.4995216172735],[-58.8030029384329,-27.4997287596813],[-58.8019468094737,-27.5004190765469],[-58.8019405882632,-27.5006582337998],[-58.8014410585883,-27.5007368778658],[-58.8009569947328,-27.5008333634533],[-58.8007752869802,-27.5008582702957],[-58.7999075015024,-27.5010003172006],[-58.799847029916,-27.501014632303],[-58.7991561862541,-27.5011498741471],[-58.7986466831555,-27.5012376590742],[-58.7975517358427,-27.5014096938946],[-58.7975830346048,-27.5017791820874],[-58.797607370172,-27.5023427283179],[-58.7978235329466,-27.502569989765],[-58.7979826685157,-27.5027122811785],[-58.7985079415734,-27.502971632616],[-58.7988648441457,-27.5031429418769],[-58.7994265474314,-27.5031537200038],[-58.7995172199421,-27.5031299925667],[-58.7999974119657,-27.5031057358407],[-58.8004011502485,-27.5030463800208],[-58.8010015521158,-27.502948389759],[-58.8016368425785,-27.5028183688941],[-58.802141586081,-27.5027486780279],[-58.8027286344588,-27.5024523747772],[-58.8032353447993,-27.5021931976677],[-58.8037720310001,-27.5019110756911],[-58.8037232586143,-27.5014019790084],[-58.8043646240196,-27.5013350195655],[-58.804450456891,-27.5013248843993],[-58.8048211168023,-27.5010990427163],[-58.8054503547066,-27.5005991916685],[-58.8061201212253,-27.5001033226033],[-58.8063899902435,-27.4999013399405],[-58.806041017356,-27.4999058711548],[-58.8059218720188,-27.4994247543354],[-58.8058533995444,-27.4992587408442],[-58.8057817614615,-27.4988988007396],[-58.8056608517826,-27.4983094454248],[-58.8050057773285,-27.4969150637194],[-58.8047704668631,-27.4964444743638],[-58.8043072633092,-27.4956475461209]]]}"
301,760,839,1599,400,387,23.8,67,"{""type"":""Polygon"",""coordinates"":[[[-58.8117508207571,-27.4988933622244],[-58.8114986834809,-27.4989417544908],[-58.8112062334689,-27.4989996929227],[-58.8101268752454,-27.4991941768104],[-58.8092290680459,-27.4993547152225],[-58.8083766284285,-27.4995056364132],[-58.8078524117751,-27.499620711105],[-58.8072777656185,-27.4997454607924],[-58.8067380790628,-27.4998426888454],[-58.8063899902435,-27.4999013399405],[-58.8061201212253,-27.5001033226033],[-58.8054503547066,-27.5005991916685],[-58.8048211168023,-27.5010990427163],[-58.804450456891,-27.5013248843993],[-58.8043646240196,-27.5013350195655],[-58.8037232586143,-27.5014019790084],[-58.8037720310001,-27.5019110756911],[-58.8044130314124,-27.5018215662788],[-58.8045011845672,-27.5025737389842],[-58.8045536945337,-27.5030015909287],[-58.8052397045328,-27.5028799174589],[-58.8054637099973,-27.5038964675239],[-58.8054692095189,-27.503923461379],[-58.8055040474275,-27.5041981724381],[-58.8055848703638,-27.5048106019962],[-58.8056601947322,-27.505396037577],[-58.8059360922463,-27.5052526185243],[-58.8063160668826,-27.5049770320812],[-58.8063959604907,-27.5049128422983],[-58.806929703149,-27.5044503114313],[-58.8070643472894,-27.5043312795607],[-58.8071790548391,-27.5042305500833],[-58.8073537183581,-27.5040839327587],[-58.8074635887497,-27.5039967985264],[-58.807767394097,-27.5037041546429],[-58.8083642208703,-27.5030784073924],[-58.8086576109198,-27.5027678536286],[-58.8089310636397,-27.5024756020497],[-58.8091198623286,-27.5022656466577],[-58.8092833719698,-27.5020560199702],[-58.8096112011,-27.5016863750874],[-58.8099276582014,-27.5012401926933],[-58.8100466795428,-27.5010942961982],[-58.8105769188741,-27.5004197870619],[-58.8114893456041,-27.4992982346293],[-58.8117508207571,-27.4988933622244]]]}"
302,632,668,1300,329,335,40.55,32,"{""type"":""Polygon"",""coordinates"":[[[-58.8155586037234,-27.4941885069318],[-58.81531128898,-27.4945300489911],[-58.815163121397,-27.4947485037418],[-58.8146362921629,-27.4953192345493],[-58.814046447895,-27.4960576872399],[-58.8133677801979,-27.4969326214528],[-58.8127333628001,-27.4977302912954],[-58.8122621395615,-27.4983002892223],[-58.8117508207571,-27.4988933622244],[-58.8114893456041,-27.4992982346293],[-58.8105769188741,-27.5004197870619],[-58.8100466795428,-27.5010942961982],[-58.8099276582014,-27.5012401926933],[-58.8096112011,-27.5016863750874],[-58.8092833719698,-27.5020560199702],[-58.8091198623286,-27.5022656466577],[-58.8089310636397,-27.5024756020497],[-58.8086576109198,-27.5027678536286],[-58.8083642208703,-27.5030784073924],[-58.807767394097,-27.5037041546429],[-58.8074635887497,-27.5039967985264],[-58.8073537183581,-27.5040839327587],[-58.8071790548391,-27.5042305500833],[-58.8070643472894,-27.5043312795607],[-58.806929703149,-27.5044503114313],[-58.8063959604907,-27.5049128422983],[-58.8063160668826,-27.5049770320812],[-58.8059360922463,-27.5052526185243],[-58.8056601947322,-27.505396037577],[-58.8051315736119,-27.5058630082595],[-58.8052800183581,-27.5059693425286],[-58.8054283161233,-27.506066656791],[-58.806226868798,-27.5060202017447],[-58.8069802683176,-27.5059968831118],[-58.8077286831461,-27.5059781360602],[-58.8082750785084,-27.5059800550929],[-58.808649506895,-27.5059842083175],[-58.8099334619028,-27.5059223973552],[-58.8111120865421,-27.5059160765495],[-58.8113751631373,-27.5052991731331],[-58.8117520538566,-27.5045274174258],[-58.8121135446748,-27.5037423288444],[-58.8123478168755,-27.5032205271926],[-58.8127075256553,-27.5023271997168],[-58.8128773735919,-27.501887432378],[-58.8130818843869,-27.5014021044123],[-58.8132630277827,-27.5010343632479],[-58.813509696905,-27.500652235028],[-58.8139981945242,-27.4999015731125],[-58.8142601053219,-27.4995237557896],[-58.8146901967123,-27.4989136901629],[-58.8152098380016,-27.4982122375954],[-58.8158866470568,-27.4972245474698],[-58.8159543416846,-27.4970342076076],[-58.8157051438054,-27.4957202882763],[-58.8155646476696,-27.4948650577199],[-58.8155090419839,-27.49455904459],[-58.8155586037234,-27.4941885069318]]]}"
303,792,809,1601,368,369,15.52,103,"{""type"":""Polygon"",""coordinates"":[[[-58.8037720310001,-27.5019110756911],[-58.8032353447993,-27.5021931976677],[-58.8027286344588,-27.5024523747772],[-58.802141586081,-27.5027486780279],[-58.8021902052036,-27.5032487556403],[-58.8023411835624,-27.5044421820597],[-58.8017451717115,-27.5044995235622],[-58.801881268197,-27.5057111866871],[-58.8020172949648,-27.5069183394105],[-58.8025779877451,-27.5068659649381],[-58.8031388269402,-27.5068226080726],[-58.8036188127263,-27.5067848083567],[-58.8037445245679,-27.506738069336],[-58.8038048514986,-27.5067147325834],[-58.8041742250405,-27.5067189633463],[-58.8044095712554,-27.5062603120419],[-58.8051315736119,-27.5058630082595],[-58.8056601947322,-27.505396037577],[-58.8055848703638,-27.5048106019962],[-58.8055040474275,-27.5041981724381],[-58.8054692095189,-27.503923461379],[-58.8054637099973,-27.5038964675239],[-58.8052397045328,-27.5028799174589],[-58.8045536945337,-27.5030015909287],[-58.8045011845672,-27.5025737389842],[-58.8044130314124,-27.5018215662788],[-58.8037720310001,-27.5019110756911]]]}"
304,943,1022,1965,486,491,27.84,71,"{""type"":""Polygon"",""coordinates"":[[[-58.802141586081,-27.5027486780279],[-58.8016368425785,-27.5028183688941],[-58.8010015521158,-27.502948389759],[-58.8004011502485,-27.5030463800208],[-58.7999974119657,-27.5031057358407],[-58.7995172199421,-27.5031299925667],[-58.7994265474314,-27.5031537200038],[-58.7988648441457,-27.5031429418769],[-58.7985079415734,-27.502971632616],[-58.7979826685157,-27.5027122811785],[-58.7978235329466,-27.502569989765],[-58.797607370172,-27.5023427283179],[-58.7976827966937,-27.5029371904006],[-58.7977228931532,-27.50353661988],[-58.7977429049635,-27.5038340796206],[-58.7977530945902,-27.5041497098314],[-58.7977734741809,-27.5047809702017],[-58.7977836651966,-27.5054078513184],[-58.7978170929628,-27.5059081272957],[-58.7978195125575,-27.5060569551644],[-58.7978589519837,-27.5066157948451],[-58.7978690709526,-27.5072381658326],[-58.7978751571556,-27.5076124903836],[-58.7978890861873,-27.5078468761902],[-58.7979195111603,-27.5084734954446],[-58.7979511812462,-27.5088655327094],[-58.7979727355825,-27.5092577007167],[-58.7980440638628,-27.5095996055034],[-58.7981876694767,-27.5097195425685],[-58.7989306838816,-27.5093671067361],[-58.7999902190061,-27.5088797553926],[-58.8004267405134,-27.5086575829035],[-58.8006378542692,-27.5085736539635],[-58.8005240081097,-27.5084172471636],[-58.8036470446826,-27.5069648772165],[-58.8041742250405,-27.5067189633463],[-58.8038048514986,-27.5067147325834],[-58.8037445245679,-27.506738069336],[-58.8036188127263,-27.5067848083567],[-58.8031388269402,-27.5068226080726],[-58.8025779877451,-27.5068659649381],[-58.8020172949648,-27.5069183394105],[-58.801881268197,-27.5057111866871],[-58.8017451717115,-27.5044995235622],[-58.8023411835624,-27.5044421820597],[-58.8021902052036,-27.5032487556403],[-58.802141586081,-27.5027486780279]]]}"
305,1054,1024,2078,462,446,31.45,66,"{""type"":""Polygon"",""coordinates"":[[[-58.8111120865421,-27.5059160765495],[-58.8099334619028,-27.5059223973552],[-58.808649506895,-27.5059842083175],[-58.8082750785084,-27.5059800550929],[-58.8077286831461,-27.5059781360602],[-58.8069802683176,-27.5059968831118],[-58.806226868798,-27.5060202017447],[-58.8054283161233,-27.506066656791],[-58.8052800183581,-27.5059693425286],[-58.8051315736119,-27.5058630082595],[-58.8044095712554,-27.5062603120419],[-58.8041742250405,-27.5067189633463],[-58.8041415615423,-27.5071975396468],[-58.804169445986,-27.507666308749],[-58.8041761423156,-27.5080767113234],[-58.8041945001076,-27.5085816909186],[-58.8042629966802,-27.509058954784],[-58.8052591282289,-27.5090279846441],[-58.8063771663888,-27.5090270001375],[-58.8061038892477,-27.5099507666529],[-58.8060085482494,-27.5103083634483],[-58.8058395455209,-27.5108022427772],[-58.8064701366914,-27.5110015529381],[-58.8069427497711,-27.511130739014],[-58.807217729586,-27.5112399375381],[-58.8078384304474,-27.5114529024247],[-58.8085450476429,-27.5116602362753],[-58.8086110981755,-27.511677420736],[-58.8092365667511,-27.5118722737218],[-58.8093748725464,-27.5116674854553],[-58.8096437670519,-27.5110956178919],[-58.8099405708729,-27.5103745281522],[-58.8101582149235,-27.5097627289237],[-58.8103319223111,-27.5089394907371],[-58.810331036226,-27.5088853719087],[-58.8103590211681,-27.5087406599954],[-58.8104903798003,-27.5081119399936],[-58.8105558740194,-27.5077863051966],[-58.8105697924078,-27.5077094393183],[-58.810682394366,-27.5071711805914],[-58.8107380672611,-27.5068637170262],[-58.8108391130134,-27.5065466409708],[-58.810956735093,-27.506315055437],[-58.8111120865421,-27.5059160765495]]]}"
306,761,855,1616,400,391,32,51,"{""type"":""Polygon"",""coordinates"":[[[-58.8041742250405,-27.5067189633463],[-58.8036470446826,-27.5069648772165],[-58.8005240081097,-27.5084172471636],[-58.8006378542692,-27.5085736539635],[-58.8004267405134,-27.5086575829035],[-58.7999902190061,-27.5088797553926],[-58.7989306838816,-27.5093671067361],[-58.7990634510247,-27.5100645756052],[-58.8001643459639,-27.5099420688124],[-58.8013463870977,-27.5098320349805],[-58.8014818766576,-27.5103851176702],[-58.8015829037353,-27.5106860375941],[-58.8017695515743,-27.5109632937692],[-58.8019698449303,-27.5114568947967],[-58.8020062808831,-27.5115195749074],[-58.8023713780308,-27.5121914745512],[-58.8030787270115,-27.5124439356205],[-58.8038160601275,-27.5126734496852],[-58.8045278843644,-27.5128897581285],[-58.8052241684135,-27.5130837102132],[-58.8073193457431,-27.513742147479],[-58.8073541633241,-27.5137056080393],[-58.8079120528204,-27.5131705849069],[-58.8086550226787,-27.5125068484661],[-58.8088097591379,-27.5123785317],[-58.8090032629931,-27.5121459606149],[-58.8092365667511,-27.5118722737218],[-58.8086110981755,-27.511677420736],[-58.8085450476429,-27.5116602362753],[-58.8078384304474,-27.5114529024247],[-58.807217729586,-27.5112399375381],[-58.8069427497711,-27.511130739014],[-58.8064701366914,-27.5110015529381],[-58.8058395455209,-27.5108022427772],[-58.8060085482494,-27.5103083634483],[-58.8061038892477,-27.5099507666529],[-58.8063771663888,-27.5090270001375],[-58.8052591282289,-27.5090279846441],[-58.8042629966802,-27.509058954784],[-58.8041945001076,-27.5085816909186],[-58.8041761423156,-27.5080767113234],[-58.804169445986,-27.507666308749],[-58.8041415615423,-27.5071975396468],[-58.8041742250405,-27.5067189633463]]]}"
307,826,873,1699,404,411,49.6,34,"{""type"":""Polygon"",""coordinates"":[[[-58.7978589519837,-27.5066157948451],[-58.7967973771275,-27.5066656002395],[-58.7960995314116,-27.5066836355932],[-58.7956747396229,-27.5066936315031],[-58.795432032771,-27.5067012757023],[-58.7954479232147,-27.5076799327975],[-58.7955844149907,-27.5076736598159],[-58.7955857285407,-27.5080660898734],[-58.7942519578216,-27.5081780317905],[-58.7942516483932,-27.5087824946112],[-58.7943436203023,-27.5097737029976],[-58.7936775655257,-27.5098815344368],[-58.7932789289318,-27.5099453167644],[-58.7931216898022,-27.5099202788737],[-58.7927230526534,-27.5099840596289],[-58.7916679606062,-27.5101239612336],[-58.7902796153145,-27.5103042324278],[-58.7897540840748,-27.5103425728713],[-58.7898426593974,-27.5111263281033],[-58.7892351719529,-27.5111025689947],[-58.7878227840961,-27.5110485589951],[-58.786587577418,-27.5110012802966],[-58.7867129961685,-27.5118747827995],[-58.7868837225923,-27.5127341701686],[-58.7878909353743,-27.5140113398486],[-58.7881111394559,-27.5151136770318],[-58.7882877919759,-27.5154001023953],[-58.788729208473,-27.5161026347281],[-58.7883300844411,-27.5164505960598],[-58.7886983750749,-27.5166984688416],[-58.7889850029025,-27.5169022823708],[-58.7891095649874,-27.5167833966046],[-58.7918653895351,-27.5145014898037],[-58.7955277703615,-27.5113507618635],[-58.7980440638628,-27.5095996055034],[-58.7979727355825,-27.5092577007167],[-58.7979511812462,-27.5088655327094],[-58.7979195111603,-27.5084734954446],[-58.7978890861873,-27.5078468761902],[-58.7978751571556,-27.5076124903836],[-58.7978690709526,-27.5072381658326],[-58.7978589519837,-27.5066157948451]]]}"
308,648,721,1369,323,345,31.31,44,"{""type"":""Polygon"",""coordinates"":[[[-58.7942519578216,-27.5081780317905],[-58.7923733818254,-27.5083872010238],[-58.7922667531352,-27.5077390070237],[-58.7921187852472,-27.5070372148292],[-58.7920725476173,-27.5066814502299],[-58.7913641453849,-27.5066725324921],[-58.7912935145625,-27.5060599608365],[-58.7909147562538,-27.5061009254996],[-58.790606735271,-27.5061364675846],[-58.7899103500004,-27.5062446708504],[-58.7887857907817,-27.5064666396039],[-58.787226170745,-27.5066896796989],[-58.7868072360661,-27.5067491931396],[-58.7865599796564,-27.5067884566021],[-58.7859393816148,-27.5068911558083],[-58.7860961251133,-27.5081386620185],[-58.7863023184813,-27.5090021062935],[-58.7864547711022,-27.5099835237077],[-58.786587577418,-27.5110012802966],[-58.7878227840961,-27.5110485589951],[-58.7892351719529,-27.5111025689947],[-58.7898426593974,-27.5111263281033],[-58.7897540840748,-27.5103425728713],[-58.7902796153145,-27.5103042324278],[-58.7916679606062,-27.5101239612336],[-58.7927230526534,-27.5099840596289],[-58.7931216898022,-27.5099202788737],[-58.7932789289318,-27.5099453167644],[-58.7936775655257,-27.5098815344368],[-58.7943436203023,-27.5097737029976],[-58.7942516483932,-27.5087824946112],[-58.7942519578216,-27.5081780317905]]]}"
309,885,1037,1922,413,387,167.55,11,"{""type"":""Polygon"",""coordinates"":[[[-58.7840334821086,-27.5057202267669],[-58.7834529138704,-27.5057953358739],[-58.7828874457365,-27.5058657381172],[-58.7818026822418,-27.5060465424258],[-58.7812627916237,-27.5061346540912],[-58.7813734676472,-27.5067241653518],[-58.7815239106018,-27.5075838213908],[-58.7817509827198,-27.508803367761],[-58.7819160251846,-27.5096267486725],[-58.7819487295941,-27.5100864417878],[-58.78078183092,-27.5101961174179],[-58.780701917918,-27.5102602933251],[-58.7791035503893,-27.5102807498388],[-58.7790782597503,-27.5102810733703],[-58.778859091329,-27.5101801260246],[-58.777557015509,-27.5094344308431],[-58.7772149335948,-27.5092403225956],[-58.7768568813858,-27.5089967974759],[-58.7758080967429,-27.5082704031644],[-58.7745291094854,-27.5073845447551],[-58.7743397921423,-27.5072516326225],[-58.7731746344764,-27.5065221907485],[-58.7729491913411,-27.5063446279717],[-58.7720819032253,-27.5084171705872],[-58.7723685523473,-27.5086255310755],[-58.775670517609,-27.5138792228329],[-58.7757485655069,-27.514013553507],[-58.7764653832619,-27.5151727234201],[-58.7771146445128,-27.5162199796799],[-58.7777691945488,-27.517280697434],[-58.7784236850075,-27.5183369013815],[-58.7790263688152,-27.5193170792048],[-58.7796923812462,-27.5204588357433],[-58.7803875972732,-27.5215280401017],[-58.7798603625219,-27.5217783791105],[-58.7793886253662,-27.5220189841261],[-58.7800180133702,-27.5230845214771],[-58.7803290201259,-27.5235451617249],[-58.7807077556576,-27.5241267278899],[-58.781561604945,-27.5234211107942],[-58.7835270798776,-27.5216817708632],[-58.7881275065372,-27.5176891852409],[-58.7884319848853,-27.5174326595277],[-58.7889858058466,-27.5169518918228],[-58.7889850029025,-27.5169022823708],[-58.7886983750749,-27.5166984688416],[-58.7883300844411,-27.5164505960598],[-58.788729208473,-27.5161026347281],[-58.7882877919759,-27.5154001023953],[-58.7881111394559,-27.5151136770318],[-58.7878909353743,-27.5140113398486],[-58.7868837225923,-27.5127341701686],[-58.7867129961685,-27.5118747827995],[-58.786587577418,-27.5110012802966],[-58.7864547711022,-27.5099835237077],[-58.7863023184813,-27.5090021062935],[-58.7860961251133,-27.5081386620185],[-58.7859393816148,-27.5068911558083],[-58.7858228221469,-27.5062521046899],[-58.7856840663813,-27.5054915440255],[-58.7849370270709,-27.5055958618076],[-58.7840334821086,-27.5057202267669]]]}"
310,572,635,1207,273,300,30.32,40,"{""type"":""Polygon"",""coordinates"":[[[-58.7740913694801,-27.5037498190723],[-58.7731059118914,-27.5060223549645],[-58.7729491913411,-27.5063446279717],[-58.7731746344764,-27.5065221907485],[-58.7743397921423,-27.5072516326225],[-58.7745291094854,-27.5073845447551],[-58.7758080967429,-27.5082704031644],[-58.7768568813858,-27.5089967974759],[-58.7772149335948,-27.5092403225956],[-58.777557015509,-27.5094344308431],[-58.778859091329,-27.5101801260246],[-58.7790782597503,-27.5102810733703],[-58.7791035503893,-27.5102807498388],[-58.780701917918,-27.5102602933251],[-58.78078183092,-27.5101961174179],[-58.7819487295941,-27.5100864417878],[-58.7819160251846,-27.5096267486725],[-58.7817509827198,-27.508803367761],[-58.7815239106018,-27.5075838213908],[-58.7813734676472,-27.5067241653518],[-58.7812627916237,-27.5061346540912],[-58.7806973924639,-27.5062095575493],[-58.7801321376055,-27.5062934787012],[-58.7795212876467,-27.5063734700436],[-58.7793951292279,-27.5063931277466],[-58.7789863059445,-27.50645248835],[-58.7784160627143,-27.5065409773192],[-58.7782481347227,-27.5064799716842],[-58.7779020908518,-27.506353579103],[-58.7766913417272,-27.5059360029053],[-58.7757448441675,-27.5055917279219],[-58.7749563779439,-27.5053221152583],[-58.7750955915533,-27.5045399501829],[-58.775154249523,-27.5040971317831],[-58.7740913694801,-27.5037498190723]]]}"
311,775,843,1618,365,331,126.88,13,"{""type"":""Polygon"",""coordinates"":[[[-58.7989306838816,-27.5093671067361],[-58.7981876694767,-27.5097195425685],[-58.7980440638628,-27.5095996055034],[-58.7955277703615,-27.5113507618635],[-58.7918653895351,-27.5145014898037],[-58.7891095649874,-27.5167833966046],[-58.7889850029025,-27.5169022823708],[-58.789157645624,-27.5169406590781],[-58.789269879608,-27.5169978564673],[-58.7895989681039,-27.5170116649591],[-58.7896910417576,-27.5170736323527],[-58.7898132468956,-27.5171216791729],[-58.7900015766875,-27.5171914290998],[-58.7901536212665,-27.517207515265],[-58.7904204022132,-27.5171228844202],[-58.7907803529996,-27.5171678689084],[-58.7910334927426,-27.5171781411991],[-58.7912314285176,-27.5172161894942],[-58.7914296567955,-27.5172722772765],[-58.7916271542207,-27.5172832653319],[-58.7918885100688,-27.5171761471772],[-58.7920500135076,-27.5171515113994],[-58.7922230230992,-27.5172124339389],[-58.792365316736,-27.5172511977737],[-58.7925422147918,-27.5172398956348],[-58.7925812923561,-27.5171536850635],[-58.7927323130111,-27.5171066292202],[-58.7929435953841,-27.5170317308932],[-58.7932983417646,-27.5170677541713],[-58.7933389553017,-27.517076252143],[-58.7934074951771,-27.5172467817046],[-58.7934665770624,-27.5174580311567],[-58.7934936254781,-27.5175659434592],[-58.7935401758272,-27.5176284953782],[-58.7936434667333,-27.5177579785953],[-58.7937716840964,-27.5178645857522],[-58.7938453568274,-27.5180395597047],[-58.7938506348599,-27.5180530242573],[-58.7938531967609,-27.5182108720653],[-58.7938222526018,-27.5184864350588],[-58.7939880032086,-27.5187233732985],[-58.7939196002525,-27.5188731149226],[-58.7940657034019,-27.5191463935669],[-58.7941928911628,-27.5195011119574],[-58.7943568868478,-27.5196298111688],[-58.7945007952948,-27.5197677911859],[-58.794726226409,-27.5199408057985],[-58.7949979907785,-27.5201628415261],[-58.7951471790329,-27.5203142852844],[-58.7952952687506,-27.5203980798752],[-58.7954419665716,-27.5203961855898],[-58.7958079406086,-27.5204997202126],[-58.7960894591021,-27.5206990732937],[-58.7962747925429,-27.5208951575848],[-58.7963839547931,-27.5210741822756],[-58.7965750078475,-27.5213107901001],[-58.7967918680009,-27.5215786402403],[-58.7969059437442,-27.521748579202],[-58.7969868830224,-27.5220587834699],[-58.7970094643194,-27.5222028396005],[-58.7969655501203,-27.522302646441],[-58.796844143036,-27.5223042155662],[-58.7967286745023,-27.5223598383421],[-58.7967258890314,-27.5224997114674],[-58.7967836606341,-27.5226297802306],[-58.7969298495533,-27.5229075650742],[-58.7970183403126,-27.5230597910432],[-58.797006244665,-27.523249404105],[-58.797055513257,-27.5234788218522],[-58.7970780950446,-27.5236228779255],[-58.7971311024201,-27.5237710515685],[-58.7971328627897,-27.5238792897817],[-58.7971355033626,-27.5240416470983],[-58.797170990204,-27.524356949506],[-58.7972028829556,-27.5244512655615],[-58.7997410357247,-27.5218517456402],[-58.8000482043161,-27.5214508124434],[-58.8009938745798,-27.5198687829981],[-58.8013782202472,-27.5192367930261],[-58.8020447316144,-27.5185334823738],[-58.803494439647,-27.5171478931208],[-58.8043735226459,-27.5164508365176],[-58.8054549022744,-27.5154398984132],[-58.8057788285887,-27.5151379750411],[-58.8062180614635,-27.5147714011514],[-58.8064769635796,-27.5145154295122],[-58.8067904730874,-27.514195595798],[-58.8073193457431,-27.513742147479],[-58.8052241684135,-27.5130837102132],[-58.8045278843644,-27.5128897581285],[-58.8038160601275,-27.5126734496852],[-58.8030787270115,-27.5124439356205],[-58.8023713780308,-27.5121914745512],[-58.8020062808831,-27.5115195749074],[-58.8019698449303,-27.5114568947967],[-58.8017695515743,-27.5109632937692],[-58.8015829037353,-27.5106860375941],[-58.8014818766576,-27.5103851176702],[-58.8013463870977,-27.5098320349805],[-58.8001643459639,-27.5099420688124],[-58.7990634510247,-27.5100645756052],[-58.7989306838816,-27.5093671067361]]]}"
312,635,664,1299,298,305,17.25,75,"{""type"":""Polygon"",""coordinates"":[[[-58.7889858058466,-27.5169518918228],[-58.7889881416957,-27.5170962102265],[-58.7889890906394,-27.5171548395771],[-58.7890616604191,-27.517262167219],[-58.7892634652443,-27.5175392456537],[-58.7898163678486,-27.5176268584431],[-58.7892709851752,-27.5180037703945],[-58.7892082916041,-27.5181940344436],[-58.7891772418624,-27.5187763385522],[-58.7891099062797,-27.5193049788801],[-58.7890727754106,-27.519824208735],[-58.7901873333151,-27.5199136132378],[-58.7913629604643,-27.5200247763563],[-58.7925335308482,-27.520135994632],[-58.7936686200043,-27.5202431498084],[-58.7942760111741,-27.520257867197],[-58.7944385435661,-27.520296367549],[-58.7945625849973,-27.5204571582585],[-58.7948222556672,-27.5205575566473],[-58.7954267879413,-27.5207076321814],[-58.7959519970855,-27.5209579689737],[-58.7962497184996,-27.5215315151118],[-58.7963536027046,-27.5220083257947],[-58.796458440825,-27.5222325149842],[-58.7965311688478,-27.5229713587726],[-58.7965926067435,-27.5233269239721],[-58.796565627605,-27.5235347728473],[-58.7971328627897,-27.5238792897817],[-58.7971311024201,-27.5237710515685],[-58.7970780950446,-27.5236228779255],[-58.797055513257,-27.5234788218522],[-58.797006244665,-27.523249404105],[-58.7970183403126,-27.5230597910432],[-58.7969298495533,-27.5229075650742],[-58.7967836606341,-27.5226297802306],[-58.7967258890314,-27.5224997114674],[-58.7967286745023,-27.5223598383421],[-58.796844143036,-27.5223042155662],[-58.7969655501203,-27.522302646441],[-58.7970094643194,-27.5222028396005],[-58.7969868830224,-27.5220587834699],[-58.7969059437442,-27.521748579202],[-58.7967918680009,-27.5215786402403],[-58.7965750078475,-27.5213107901001],[-58.7963839547931,-27.5210741822756],[-58.7962747925429,-27.5208951575848],[-58.7960894591021,-27.5206990732937],[-58.7958079406086,-27.5204997202126],[-58.7954419665716,-27.5203961855898],[-58.7952952687506,-27.5203980798752],[-58.7951471790329,-27.5203142852844],[-58.7949979907785,-27.5201628415261],[-58.794726226409,-27.5199408057985],[-58.7945007952948,-27.5197677911859],[-58.7943568868478,-27.5196298111688],[-58.7941928911628,-27.5195011119574],[-58.7940657034019,-27.5191463935669],[-58.7939196002525,-27.5188731149226],[-58.7939880032086,-27.5187233732985],[-58.7938222526018,-27.5184864350588],[-58.7938531967609,-27.5182108720653],[-58.7938506348599,-27.5180530242573],[-58.7938453568274,-27.5180395597047],[-58.7937716840964,-27.5178645857522],[-58.7936434667333,-27.5177579785953],[-58.7935401758272,-27.5176284953782],[-58.7934936254781,-27.5175659434592],[-58.7934665770624,-27.5174580311567],[-58.7934074951771,-27.5172467817046],[-58.7933389553017,-27.517076252143],[-58.7932983417646,-27.5170677541713],[-58.7929435953841,-27.5170317308932],[-58.7927323130111,-27.5171066292202],[-58.7925812923561,-27.5171536850635],[-58.7925422147918,-27.5172398956348],[-58.792365316736,-27.5172511977737],[-58.7922230230992,-27.5172124339389],[-58.7920500135076,-27.5171515113994],[-58.7918885100688,-27.5171761471772],[-58.7916271542207,-27.5172832653319],[-58.7914296567955,-27.5172722772765],[-58.7912314285176,-27.5172161894942],[-58.7910334927426,-27.5171781411991],[-58.7907803529996,-27.5171678689084],[-58.7904204022132,-27.5171228844202],[-58.7901536212665,-27.517207515265],[-58.7900015766875,-27.5171914290998],[-58.7898132468956,-27.5171216791729],[-58.7896910417576,-27.5170736323527],[-58.7895989681039,-27.5170116649591],[-58.789269879608,-27.5169978564673],[-58.789157645624,-27.5169406590781],[-58.7889850029025,-27.5169022823708],[-58.7889858058466,-27.5169518918228]]]}"
313,732,788,1520,351,328,11.09,137,"{""type"":""Polygon"",""coordinates"":[[[-58.7889858058466,-27.5169518918228],[-58.7884319848853,-27.5174326595277],[-58.7881275065372,-27.5176891852409],[-58.7880119650217,-27.5186785559453],[-58.7879946982457,-27.5191749758351],[-58.7879073415818,-27.5197174058858],[-58.7878394888721,-27.5202144761908],[-58.7877920888815,-27.5207248161302],[-58.7877144828755,-27.5212445662047],[-58.7888594793756,-27.5213381003916],[-58.7900252960965,-27.5214674440981],[-58.7911956618857,-27.5215651431294],[-58.7923708683279,-27.5216492371742],[-58.7924098855844,-27.5212472656903],[-58.7924186129521,-27.5211614464215],[-58.7924862258009,-27.520650845082],[-58.7925074953839,-27.5204024723475],[-58.7925335308482,-27.520135994632],[-58.7913629604643,-27.5200247763563],[-58.7901873333151,-27.5199136132378],[-58.7890727754106,-27.519824208735],[-58.7891099062797,-27.5193049788801],[-58.7891772418624,-27.5187763385522],[-58.7892082916041,-27.5181940344436],[-58.7892709851752,-27.5180037703945],[-58.7898163678486,-27.5176268584431],[-58.7892634652443,-27.5175392456537],[-58.7890616604191,-27.517262167219],[-58.7889890906394,-27.5171548395771],[-58.7889881416957,-27.5170962102265],[-58.7889858058466,-27.5169518918228]]]}"
316,847,926,1773,406,431,178.87,10,"{""type"":""Polygon"",""coordinates"":[[[-58.7881275065372,-27.5176891852409],[-58.7835270798776,-27.5216817708632],[-58.781561604945,-27.5234211107942],[-58.7807077556576,-27.5241267278899],[-58.7803140722606,-27.5245016633963],[-58.7800595621282,-27.5247214454388],[-58.7759979599288,-27.5282738508726],[-58.7716362371144,-27.5320600265464],[-58.7736360764429,-27.5330720303302],[-58.7737277211623,-27.5331069480915],[-58.7738244251251,-27.5331418012256],[-58.773916069956,-27.5331767188568],[-58.7740077148418,-27.5332116364247],[-58.7740992873448,-27.533242043953],[-58.774190859895,-27.5332724514185],[-58.7742874916872,-27.53330279424],[-58.7743790643333,-27.5333332015763],[-58.7744756962236,-27.5333635442616],[-58.7745672689655,-27.5333939514688],[-58.7746639009539,-27.5334242940181],[-58.7747554013263,-27.5334501911217],[-58.7748519609394,-27.5334760235609],[-58.7749485930674,-27.5335063659048],[-58.7750400935646,-27.5335322628142],[-58.7751366533054,-27.5335580950487],[-58.7752381998071,-27.5335793526244],[-58.7753347596279,-27.5336051847169],[-58.7754312469968,-27.5336265067674],[-58.7755278068967,-27.5336523387216],[-58.7756242943366,-27.5336736606342],[-58.7757207818101,-27.5336949824779],[-58.7758172693171,-27.5337163042529],[-58.775913684344,-27.5337331159875],[-58.776010171914,-27.5337544376251],[-58.7761066595176,-27.5337757591937],[-58.7762030746292,-27.5337925707229],[-58.7763045489784,-27.5338093175281],[-58.7764009641416,-27.5338261289171],[-58.7764973793302,-27.5338429402377],[-58.7765988537581,-27.5338596868235],[-58.7766951964525,-27.5338719880345],[-58.7767916117143,-27.5338887991468],[-58.7768930136625,-27.5339010355446],[-58.7769893564139,-27.5339133365483],[-58.7770907583981,-27.5339255727996],[-58.7771871011849,-27.5339378736641],[-58.7772884306349,-27.533945599801],[-58.7773847734532,-27.5339579005265],[-58.777486102927,-27.5339656265177],[-58.7775824457767,-27.5339779271041],[-58.7776837752742,-27.5339856529496],[-58.7777851047814,-27.5339933787205],[-58.7778813024872,-27.533996659164],[-58.7779826320098,-27.5340043847897],[-58.7780789023257,-27.5340121750617],[-58.778180159261,-27.5340153905762],[-58.7782814161978,-27.5340186060167],[-58.7783776139199,-27.5340218861148],[-58.7784788708598,-27.5340251014108],[-58.7785801278012,-27.5340283166327],[-58.7786762529011,-27.5340270865587],[-58.7787319769015,-27.5340308843445],[-58.7787775098416,-27.5340303016364],[-58.7788786941481,-27.5340290066761],[-58.778974819233,-27.5340277763956],[-58.7790760035262,-27.5340264812917],[-58.7791771878128,-27.5340251861143],[-58.7792783720925,-27.5340238908633],[-58.7793744244963,-27.534018150344],[-58.7794756087588,-27.5340168549498],[-58.780449492067,-27.5338465020081],[-58.7822286945438,-27.5334086978579],[-58.7837907750755,-27.5330007232817],[-58.7857002462243,-27.5324845186413],[-58.7862245719365,-27.532365009521],[-58.7864866249144,-27.5322984893186],[-58.7876807444114,-27.5319809074991],[-58.7888653956436,-27.5317040354139],[-58.7900850153184,-27.531399637812],[-58.7907644062802,-27.5311698537398],[-58.7913168794622,-27.5309146368122],[-58.7913668847591,-27.5308779053643],[-58.7919119549461,-27.530478433492],[-58.7925266030374,-27.5300013774748],[-58.7933646530659,-27.5292598061041],[-58.792502088675,-27.5284905497608],[-58.7923932903286,-27.5283340719235],[-58.792522813234,-27.5269610948869],[-58.7925688019768,-27.5263650659148],[-58.7927092344012,-27.5253528181771],[-58.7919443344837,-27.5252995273276],[-58.7907893242583,-27.5252151708981],[-58.7908569460444,-27.5247045701572],[-58.7896559022427,-27.5245892208438],[-58.7884599920836,-27.5244783058974],[-58.7873656964197,-27.5243931395218],[-58.7874025437833,-27.5238558701943],[-58.7875006789917,-27.5233538999613],[-58.7875476430083,-27.5228165004878],[-58.7876144765582,-27.5222562910625],[-58.7876464098998,-27.5217281065464],[-58.7877144828755,-27.5212445662047],[-58.7877920888815,-27.5207248161302],[-58.7878394888721,-27.5202144761908],[-58.7879073415818,-27.5197174058858],[-58.7879946982457,-27.5191749758351],[-58.7880119650217,-27.5186785559453],[-58.7881275065372,-27.5176891852409]]]}"
317,792,861,1653,401,436,224.58,7,"{""type"":""Polygon"",""coordinates"":[[[-58.7720819032253,-27.5084171705872],[-58.7701622430441,-27.5130156891473],[-58.7692111019926,-27.515229121512],[-58.7687334218028,-27.516362927848],[-58.7672463401142,-27.5198687760224],[-58.7655348974207,-27.5239052367207],[-58.7651810958315,-27.5248795767451],[-58.7649649588316,-27.5259198320456],[-58.7649633421731,-27.5264521408632],[-58.7650053827932,-27.5268666115148],[-58.7651515569423,-27.5274647075126],[-58.7653043917988,-27.5278461946941],[-58.7655016775819,-27.528159453382],[-58.7658450137198,-27.5287460223791],[-58.7661030110224,-27.5290585088346],[-58.7663445347299,-27.5292900076232],[-58.7667089189695,-27.5296101627875],[-58.767164296251,-27.5299246492509],[-58.7683577175044,-27.5305094235179],[-58.7712841909879,-27.5318795660323],[-58.7716362371144,-27.5320600265464],[-58.7759979599288,-27.5282738508726],[-58.7800595621282,-27.5247214454388],[-58.7803140722606,-27.5245016633963],[-58.7807077556576,-27.5241267278899],[-58.7803290201259,-27.5235451617249],[-58.7800180133702,-27.5230845214771],[-58.7793886253662,-27.5220189841261],[-58.7798603625219,-27.5217783791105],[-58.7803875972732,-27.5215280401017],[-58.7796923812462,-27.5204588357433],[-58.7790263688152,-27.5193170792048],[-58.7784236850075,-27.5183369013815],[-58.7777691945488,-27.517280697434],[-58.7771146445128,-27.5162199796799],[-58.7764653832619,-27.5151727234201],[-58.7757485655069,-27.514013553507],[-58.775670517609,-27.5138792228329],[-58.7723685523473,-27.5086255310755],[-58.7720819032253,-27.5084171705872]]]}"
318,250,266,516,116,124,80.86,6,"{""type"":""Polygon"",""coordinates"":[[[-58.7651810958315,-27.5248795767451],[-58.7638808766424,-27.5277424694984],[-58.7635658856333,-27.5282967979719],[-58.7632000854349,-27.5288382375126],[-58.7622709549183,-27.5299100855411],[-58.7613028437069,-27.5310771510662],[-58.7603282157213,-27.5321540744793],[-58.7594596691286,-27.533220626931],[-58.7574486407526,-27.5356323471448],[-58.7550303907453,-27.5385363632735],[-58.7554776021733,-27.5383367454049],[-58.756156758418,-27.5380845753129],[-58.7568754542599,-27.5377732601862],[-58.7577960923807,-27.5374323219839],[-58.7587894955386,-27.5372122518906],[-58.7598549477437,-27.5370679481399],[-58.7610986262735,-27.5369935527304],[-58.7618461221506,-27.5369028824854],[-58.7627451822206,-27.5367967532904],[-58.7631487090272,-27.5367149491936],[-58.7633757330702,-27.5366714707611],[-58.7640010068492,-27.5365327196526],[-58.7648955205129,-27.5361424469532],[-58.7664409498302,-27.5356356356304],[-58.7676888039886,-27.5351912343016],[-58.7680485972884,-27.5349069816038],[-58.7685971745795,-27.5344038023887],[-58.7692060242671,-27.5338727885231],[-58.7705278524519,-27.532678610654],[-58.7712841909879,-27.5318795660323],[-58.7683577175044,-27.5305094235179],[-58.767164296251,-27.5299246492509],[-58.7667089189695,-27.5296101627875],[-58.7663445347299,-27.5292900076232],[-58.7661030110224,-27.5290585088346],[-58.7658450137198,-27.5287460223791],[-58.7655016775819,-27.528159453382],[-58.7653043917988,-27.5278461946941],[-58.7651515569423,-27.5274647075126],[-58.7650053827932,-27.5268666115148],[-58.7649633421731,-27.5264521408632],[-58.7649649588316,-27.5259198320456],[-58.7651810958315,-27.5248795767451]]]}"
319,636,649,1285,270,264,14.85,87,"{""type"":""Polygon"",""coordinates"":[[[-58.7864261397223,-27.5429494532057],[-58.7853113493843,-27.5428600297162],[-58.7851824977844,-27.5430285876126],[-58.7851041126169,-27.5438144875697],[-58.7850238754335,-27.5447988898928],[-58.784925905979,-27.5456256391386],[-58.7848330396431,-27.5467680841736],[-58.7847542578168,-27.5478426849705],[-58.7846549438833,-27.5488995058475],[-58.7844738388367,-27.550219007918],[-58.7846875960489,-27.5502929472048],[-58.7850235945609,-27.5504149353111],[-58.7854764364488,-27.550251235961],[-58.7860216938051,-27.5498562926396],[-58.786436119705,-27.549508138272],[-58.7868165615099,-27.549561887522],[-58.786898520036,-27.5499352359422],[-58.7869860647049,-27.549090576731],[-58.78702430223,-27.5486389975962],[-58.787086305456,-27.5480923844168],[-58.7871741183977,-27.5475770153388],[-58.7872368507659,-27.5470755014261],[-58.7872874186747,-27.5464478394592],[-58.7873239752953,-27.5458925316645],[-58.7867105793348,-27.5458282463526],[-58.7861326750261,-27.5457680129657],[-58.7862348195113,-27.5448870790009],[-58.7863253111017,-27.5439115662941],[-58.7864261397223,-27.5429494532057]]]}"
